☼ ☼ ☼ ☼ ☼ ☼ ☼ ☼ ☼ ☼ ☼ ☼ ☼ ☼ ☼ ☼ ☼ ☼ ☼ ☼ ☼ ☼ ☼ ☼ ☼ ☼ ☼ ☼ ☼ ☼ ☼ ☼ ☼ ☼
☼   ¿   ¿     ¿         ¿        ¿        ¿     ¿    ¿    ¿    ¿  ☼
☼                                                                 ☼
☼                                                                 ☼
☼                                                                 ☼
☼                                                                 ☼
☼                                                                 ☼
☼                                                                 ☼
☼                                                                 ☼
☼                                                                 ☼
☼                                                                 ☼
☼                                                                 ☼
☼                                                                 ☼
☼                                                                 ☼
☼                                                                 ☼
☼                                                                 ☼
☼ ☼ ☼                                                         ☼ ☼ ☼
☼                                                                 ☼
☼                                                                 ☼
☼                                                                 ☼
☼                                                                 ☼
☼                                                                 ☼
☼                                                                 ☼
☼                                                                 ☼
☼                                                                 ☼
☼                                                                 ☼
☼                                                                 ☼
☼                                                                 ☼
☼                                                                 ☼
☼                         ╬ ╬ ╬ ╬ ╬ ╬ ╬ ╬                         ☼
☼                         ╬ ╬ ╬ ╬ ╬ ╬ ╬ ╬                         ☼
☼                         ╬ ╬         ╬ ╬                         ☼
☼ ¿                       ╬ ╬       ¿ ╬ ╬                       ¿ ☼
☼ ☼ ☼ ☼ ☼ ☼ ☼ ☼ ☼ ☼ ☼ ☼ ☼ ☼ ☼ ☼ ☼ ☼ ☼ ☼ ☼ ☼ ☼ ☼ ☼ ☼ ☼ ☼ ☼ ☼ ☼ ☼ ☼ ☼
