☼ ☼ ☼ ☼ ☼ ☼ ☼ ☼ ʘ ☼ ☼ ☼ ☼ ☼ ☼ ☼ ☼ ☼ ☼ ☼ ☼ ☼ ☼ ☼ ☼ ☼ ☼ ʘ ☼ ☼ ☼ ☼ ☼ ☼
☼   ¿         ¿          ¿                 ¿        ¿         ¿   ☼
☼                                                                 ☼
☼     ╬ ╬ ╬     ╬ ╬ ╬     ╬ ╬ ╬     ╬ ╬ ╬     ╬ ╬ ╬     ╬ ╬ ╬     ☼
☼     ╬ ╬ ╬     ╬ ╬ ╬     ╬ ╬ ╬     ╬ ╬ ╬     ╬ ╬ ╬     ╬ ╬ ╬     ☼
☼     ╬ ╬ ╬     ╬ ╬ ╬     ╬ ╬ ╬     ╬ ╬ ╬     ╬ ╬ ╬     ╬ ╬ ╬     ☼
☼     ╬ ╬ ╬     ╬ ╬ ╬     ╬ ╬ ╬ ☼ ☼ ╬ ╬ ╬     ╬ ╬ ╬     ╬ ╬ ╬     ☼
ʘ     ╬ ╬ ╬     ╬ ╬ ╬     ╬ ╬ ╬ ☼ ☼ ╬ ╬ ╬     ╬ ╬ ╬     ╬ ╬ ╬     ʘ
☼     ╬ ╬ ╬     ╬ ╬ ╬     ╬ ╬ ╬ ☼ ☼ ╬ ╬ ╬     ╬ ╬ ╬     ╬ ╬ ╬     ☼
☼     ╬ ╬ ╬     ╬ ╬ ╬     ╬ ╬ ╬     ╬ ╬ ╬     ╬ ╬ ╬     ╬ ╬ ╬     ☼
☼     ╬ ╬ ╬     ╬ ╬ ╬     ╬ ╬ ╬     ╬ ╬ ╬     ╬ ╬ ╬     ╬ ╬ ╬     ☼
☼     ╬ ╬ ╬     ╬ ╬ ╬                         ╬ ╬ ╬     ╬ ╬ ╬     ☼
☼     ╬ ╬ ╬     ╬ ╬ ╬                         ╬ ╬ ╬     ╬ ╬ ╬     ☼
☼                         ╬ ╬ ╬     ╬ ╬ ╬                         ☼
☼                         ╬ ╬ ╬     ╬ ╬ ╬                         ☼
☼           ╬ ╬ ╬ ╬ ╬     ╬ ╬ ╬     ╬ ╬ ╬     ╬ ╬ ╬ ╬ ╬           ☼
☼ ☼ ☼       ╬ ╬ ╬ ╬ ╬                         ╬ ╬ ╬ ╬ ╬       ☼ ☼ ☼
☼                                                                 ☼
☼                         ╬ ╬ ╬     ╬ ╬ ╬                         ☼
☼     ╬ ╬ ╬     ╬ ╬ ╬     ╬ ╬ ╬     ╬ ╬ ╬     ╬ ╬ ╬     ╬ ╬ ╬     ☼
☼     ╬ ╬ ╬     ╬ ╬ ╬     ╬ ╬ ╬     ╬ ╬ ╬     ╬ ╬ ╬     ╬ ╬ ╬     ☼
☼     ╬ ╬ ╬     ╬ ╬ ╬     ╬ ╬ ╬ ╬ ╬ ╬ ╬ ╬     ╬ ╬ ╬     ╬ ╬ ╬     ☼
☼     ╬ ╬ ╬     ╬ ╬ ╬     ╬ ╬ ╬ ╬ ╬ ╬ ╬ ╬     ╬ ╬ ╬     ╬ ╬ ╬     ☼
☼     ╬ ╬ ╬     ╬ ╬ ╬     ╬ ╬ ╬     ╬ ╬ ╬     ╬ ╬ ╬     ╬ ╬ ╬     ☼
☼     ╬ ╬ ╬     ╬ ╬ ╬     ╬ ╬ ╬     ╬ ╬ ╬     ╬ ╬ ╬     ╬ ╬ ╬     ☼
☼     ╬ ╬ ╬     ╬ ╬ ╬     ╬ ╬ ╬     ╬ ╬ ╬     ╬ ╬ ╬     ╬ ╬ ╬     ☼
☼     ╬ ╬ ╬     ╬ ╬ ╬     ╬ ╬ ╬     ╬ ╬ ╬     ╬ ╬ ╬     ╬ ╬ ╬     ☼
☼     ╬ ╬ ╬                                             ╬ ╬ ╬     ☼
☼     ╬ ╬ ╬     ◊                                       ╬ ╬ ╬     ☼
☼     ╬ ╬ ╬               ╬ ╬ ╬ ╬ ╬ ╬ ╬ ╬               ╬ ╬ ╬     ☼
☼     ╬ ╬ ╬               ╬ ╬ ╬ ╬ ╬ ╬ ╬ ╬               ╬ ╬ ╬     ☼
ʘ                         ╬ ╬         ╬ ╬                         ʘ
☼                         ╬ ╬         ╬ ╬                         ☼
☼ ☼ ☼ ☼ ☼ ☼ ☼ ☼ ʘ ☼ ☼ ☼ ☼ ☼ ☼ ☼ ☼ ☼ ☼ ☼ ☼ ☼ ☼ ☼ ☼ ☼ ☼ ʘ ☼ ☼ ☼ ☼ ☼ ☼
