☼ 2 ☼ ☼ ☼ ☼ ☼ ☼ ☼ ☼ ☼ ☼ ☼ ☼ ☼ ☼ ☼ ☼ ☼ ☼ ☼ ☼ ☼ ☼ ☼ ☼ ☼ ☼ ☼ ☼ ☼ ☼ ☼ ☼
☼     ☼             ☼                                             ☼
☼     ☼                     ☼      □                              ☼
☼     ☼ ╬ ╬     ╬ ╬ ╬     ╬ ╬ ╬   ╬ ╬ ╬ □ □ □ ╬ ╬ ╬     ╬ ☼ ╬ □ □ ☼
☼     ╬ ╬ ╬ □   ╬ ☼ ╬     ╬ ╬ ╬   ╬ ╬ ╬ ͱ □ □ ╬ ╬ ╬     ╬ ☼ ╬ @ □ ☼
☼                 ╬ □     ╬ ╬ ╬   ╬ ╬ ╬ □ □ ͱ ╬ ╬ ╬ = ͱ ╬ ☼ ╬     ☼
☼             □ ╬ ☼ ╬     ╬ ╬ ╬   ☼ ╬ ╬ □ □ □ ╬ ╬ ╬ = @ ╬ ╬ ☼ 1   ☼
☼     ╬ ╬ ╬       ╬ @     ╬ ╬ ╬   ☼ ╬ ╬ @ □ @ ╬ ╬ ╬ = = ╬ ╬ ╬ ☼ ☼ ☼
☼     ╬ ╬ ╬     ╬ ☼ ╬     ╬ ╬ ╬ ͱ ☼ ╬ ╬ □ □ □ ╬ ╬ ╬ ͱ = ╬ ╬ ╬ ╬ ╬ ☼
☼ ☼ ☼ ☼ ☼ ╬     ╬ ☼ ╬     ╬ ╬ ╬   ╬ ╬ ╬ □ @ □ ╬ ╬ ╬ @ = ╬ ╬ ╬ ╬ ╬ ☼
☼     ╬ ╬ ╬     ╬ ╬ ╬     ╬ ╬ ╬     ╬ ╬ □ □ ͱ ╬ ╬ ╬ = = ╬ ╬ ╬ ╬ ╬ ☼
☼     ╬ ╬ ╬     ╬ ☼ ╬                         ╬ ╬ ╬ = ͱ ╬ ╬ ╬     ☼
☼     ╬ ╬ ╬   @ ╬ ╬ ╬                         ╬ ╬ ╬ = = ╬ ╬ ╬     ☼
☼                     □ □ ☼ ╬ ╬     ╬ ╬ ╬               @         ☼
☼                     □ □ ☼ ╬ ╬ ͱ ͱ ╬ ╬ ╬                         ☼
☼           ╬ ╬ ╬ ╬ ╬ ͱ   ╬ ╬ ╬     ╬ ╬ ╬     ╬ ╬ ╬ ☼ ╬           ☼
☼ ☼ ☼       ╬ ╬ ╬ ╬ ╬   ͱ                     ╬ ☼ ╬ ╬ ╬       ☼ ☼ ☼
☼ ☺                ╬                                              ☼
☼                  ╬      ╬ ╬ ╬     ╬ ╬ ╬                 = =     ☼
☼     ╬ ╬ ╬     ╬ ╬ ╬ ☼ ☼ ╬ ╬ ╬   ͱ ╬ ╬ ╬     ╬ ╬ ╬     ╬ ╬ ╬     ☼
☼     ╬ ╬ ╬ ͱ   ╬ ╬ ╬     ╬ ╬ ╬     ╬ ╬ ╬     ╬ ╬ ╬     ╬ ╬ ╬     ☼
☼     ☼ ╬ ╬       □               ╬ ╬ ╬ ╬     ╬ ╬ ╬ ╬ ╬ ╬ ╬ ╬     ☼
☼ □ □ ☼ ╬ ╬       □       ╬ ╬ ╬   ╬ ╬ ╬ ╬     ╬ ╬ ╬ □ ╬ ╬ ╬ ╬ = @ ☼
☼     ☼ ╬ ╬     ╬ ╬ ╬ ☼ ☼ ╬ ╬ ╬     ╬ ╬ ╬ ☼   ╬ ╬ ╬     ╬ ╬ ╬     ☼
☼ □ □ ☼ ☼ ╬     ╬ ╬ ╬     ╬ ╬ ╬     ╬ ╬ ╬     ╬ ╬ ╬     ╬ ╬ ╬ @   ☼
☼       ╬ ╬     ╬ ╬ ╬     ╬ ╬ ╬ ͱ   ╬ ╬ ╬     ╬ ╬ ╬ ╬   ╬ ╬ ╬     ☼
☼         ╬   ͱ ╬ ╬ ╬     ╬ ╬ ╬     ╬ ╬ ╬   ͱ ╬ ╬ ╬     ╬ ╬ ╬   @ ☼
☼     ╬ @ ╬                       ͱ                     ╬ ╬ ╬     ☼
☼ □   ☼ ☼ ╬     ◊                       ͱ           □ □ ╬ ╬ ╬ = = ☼
☼     ☼ ╬ ╬                 ☼ ☼ ☼ ☼ ☼ ☼         ͱ □ @ □ ╬ ╬ ╬     ☼
☼   □ ☼ ╬ ╬               ‖ □ □       ☼           □ □ □ 2 ╬ ╬     ☼
☼     ☼                   ‖ @ □       ☼         ͱ ‖ □ □ □ @ □     ☼
☼                         ‖ □ □       ☼         @ □ □ @ □ □ □     ☼
☼ ☼ ☼ ☼ ☼ ☼ ☼ ☼ ☼ ☼ ☼ ☼ ☼ ☼ ☼ ☼ 1 ☼ ☼ ☼ ☼ ☼ ☼ ☼ ☼ ☼ ☼ ☼ ☼ ☼ ☼ ☼ ☼ ☼
