☼ ☼ ☼ ☼ ☼ ☼ ☼ ☼ 1 ☼ ☼ ☼ ☼ ☼ ☼ ☼ ☼ ☼ ☼ ☼ ☼ ☼ ☼ ☼ ☼ ☼ ☼ ☼ ☼ ☼ ☼ ☼ ☼ ☼
☼   ¿   ¿     ¿         ¿   1    ¿    2   ¿     ¿    ¿    ¿    ¿  ☼
☼                                □                                ☼
☼     ╬ ╬ ╬     ╬ ╬ ╬     ╬ ╬ ╬     ╬ ╬ ╬     ╬ ╬ ╬     ╬ ╬ ╬     ☼
☼     1                   ╬ ╬ ╬     ╬ ╬ ╬     ╬ ╬ ╬     1         ☼
☼                         ╬ ╬ ╬     ╬ ╬ ╬     ╬ ╬ ╬               ☼
☼               ╬ ╬ ╬     ╬ ╬ ╬     ╬ ╬ ╬     ╬ ╬ ╬               ☼
☼                         ╬ ╬ ╬     ╬ ╬ ╬     ╬ ╬ ╬               ☼
☼       ͱ ͱ ͱ   ╬ ╬ ╬     ╬ ╬ ╬     ╬ ╬ ╬     ╬ ╬ ╬               ☼
☼ ‖     ͱ ͱ ͱ             ╬ ╬ ╬     ╬ ╬ ╬     ╬ ╬ ╬     ͱ ͱ ͱ     ☼
☼ ‖                       ╬ ╬ ╬     ╬ ╬ ╬     ╬ ╬ ╬               ☼
☼                                             ╬ ╬ ╬               ☼
☼     ╬ ╬ ╬     ╬ ╬ ╬                         ╬ ╬ ╬               ☼
☼                         ╬ ╬ ╬     ╬ ╬ ╬               ͱ ͱ ͱ     ☼
☼                         ╬ ╬ ╬ 2   ╬ ╬ ╬                         ☼
☼           ╬ ╬ ╬ ╬ ╬     ╬ ╬ ╬     ╬ ╬ ╬     ╬ ╬ ╬ ╬ ╬           ☼
☼ ☼ ☼       ╬ ╬ ╬ ╬ ╬                         ╬ ╬ ╬ ╬ ╬       ☼ ☼ ☼
☼                                                                 ☼
☼                         ╬ ╬ ╬     ╬ ╬ ╬                  = =  1 ☼
☼     ╬ ╬ ╬     ╬ ╬ ╬     ╬ ╬ ╬     ╬ ╬ ╬     ╬ ╬ ╬     ╬ ╬ ╬     ☼
☼     ╬ ╬ ╬     ╬ ╬ ╬     ╬ ╬ ╬     ╬ ╬ ╬     ╬ ╬ ╬     ╬ ╬ ╬     ☼
☼     ╬ ╬ ╬     ╬ ╬ ╬     ╬ ╬ ╬ ╬ ╬ ╬ ╬ ╬     ╬ ╬ ╬     ╬ ╬ ╬     ☼
☼     ╬ ╬ ╬     ╬ ╬ ╬     ╬ ╬ ╬ ╬ ╬ ╬ ╬ ╬     ╬ ╬ ╬     ╬ ╬ ╬     ☼
☼     ╬ ╬ ╬     ╬ ╬ ╬     ╬ ╬ ╬     ╬ ╬ ╬     ╬ ╬ ╬     ╬ ╬ ╬     ☼
☼     ╬ ╬ ╬     ╬ ╬ ╬     ╬ ╬ ╬     ╬ ╬ ╬     ╬ ╬ ╬     ╬ ╬ ╬     ☼
☼     ╬ ╬ ╬     ╬ ╬ ╬     ╬ ╬ ╬     ╬ ╬ ╬     ╬ ╬ ╬     ╬ ╬ ╬     ☼
☼     ╬ ╬ ╬     ╬ ╬ ╬     ╬ ╬ ╬     ╬ ╬ ╬     ╬ ╬ ╬     ╬ ╬ ╬     ☼
☼     ╬ ╬ ╬                                             ╬ ╬ ╬     ☼
☼     ╬ ╬ ╬     ◊                                       ╬ ╬ ╬     ☼
☼     ╬ ╬ ╬               ╬ ╬ ╬ ╬ ╬ ╬ ╬ ╬               ╬ ╬ ╬     ☼
☼   1 ╬ ╬ ╬               ╬ ╬ ╬ ╬ ╬ ╬ ╬ ╬               ╬ ╬ ╬ 1   ☼
☼                         ╬ ╬         ╬ ╬                         ☼
☼ ¿                       ╬ ╬   2   ¿ ╬ ╬                       ¿ ☼
☼ ☼ ☼ ☼ ☼ ☼ ☼ ☼ 1 ☼ ☼ ☼ ☼ ☼ ☼ ☼ ☼ ☼ ☼ ☼ ☼ ☼ ☼ ☼ ☼ ☼ ☼ ☼ ☼ ☼ ☼ ☼ ☼ ☼
