☼ ☼ ☼ ☼ ☼ ☼ ☼ ☼ ☼ ☼ ☼ ☼ ☼ ʘ ☼ ☼ ☼ ☼ ☼ ☼ ☼ ☼ ☼ ☼ ☼ ☼ ☼ ☼ ☼ ☼ ☼ ☼ ☼ ☼ ☼ ☼ ☼ ☼ ☼ ☼ ☼ ☼ ☼ ☼ ☼ ☼ ☼ ☼ ☼ ☼ ʘ ☼ ☼ ☼ ☼ ☼ ☼ ☼ ☼ ☼ ☼ ☼ ☼ ☼ ☼ ☼ ☼ ☼ ☼ ☼ ☼ ☼ ☼ ☼ ☼ ☼ ☼ ☼ ☼ ☼ ☼ ☼ ☼ ☼ ☼ ☼ ʘ ☼ ☼ ☼ ☼ ☼ ☼ ☼ ☼ ☼ ☼ ☼ ☼ ☼ ☼ ☼
☼   ¿         ¿         ¿                 ¿          ¿            ☼ ☼             ¿         ¿                 ¿                       ☼ ☼             ¿         ¿                 ¿          ¿         ¿  ☼
☼                                                                                                                                                                                                         ☼
☼     ╬ ╬ ╬     ╬ ╬ ╬                         ╬ ╬ ╬                                           ╬             ╬                                           ╬ ╬ ╬                         ╬ ╬ ╬     ╬ ╬ ╬     ☼
☼     ╬ ╬ ╬     ╬ ╬ ╬     ╬ ╬ ╬     ╬ ╬ ╬     ╬ ╬ ╬                                           ╬ ╬         ╬ ╬                                           ╬ ╬ ╬     ╬ ╬ ╬     ╬ ╬ ╬     ╬ ╬ ╬     ╬ ╬ ╬     ☼
☼     ╬ ╬ ╬     ╬ ╬ ╬     ╬ ╬ ╬     ╬ ╬ ╬     ╬ ╬ ╬     ╬ ╬ ╬             ╬ ╬ ╬     ╬ ╬ ╬     ╬ ╬ ╬     ╬ ╬ ╬     ╬ ╬ ╬     ╬ ╬ ╬             ╬ ╬ ╬     ╬ ╬ ╬     ╬ ╬ ╬     ╬ ╬ ╬     ╬ ╬ ╬     ╬ ╬ ╬     ☼
ʘ     ╬ ╬ ╬     ╬ ╬ ╬     ╬ ╬ ╬ ☼ ☼ ╬ ╬ ╬               ╬ ╬ ╬             ╬ ╬ ╬     ╬ ╬ ╬     ╬ ╬ ╬ ☼ ☼ ╬ ╬ ╬     ╬ ╬ ╬     ╬ ╬ ╬             ╬ ╬ ╬               ╬ ╬ ╬ ☼ ☼ ╬ ╬ ╬     ╬ ╬ ╬     ╬ ╬ ╬     ʘ
☼     ╬ ╬ ╬               ╬ ╬ ╬ ☼ ☼ ╬ ╬ ╬               ╬ ╬ ╬             ╬ ╬ ╬     ╬ ╬ ╬     ╬ ╬ ╬ ☼ ☼ ╬ ╬ ╬     ╬ ╬ ╬     ╬ ╬ ╬             ╬ ╬ ╬               ╬ ╬ ╬ ☼ ☼ ╬ ╬ ╬               ╬ ╬ ╬     ☼
☼     ╬ ╬ ╬               ╬ ╬ ╬ ☼ ☼ ╬ ╬ ╬               ╬ ╬ ╬             ╬ ╬ ╬     ╬ ╬ ╬     ╬ ╬ ╬ ☼ ☼ ╬ ╬ ╬     ╬ ╬ ╬     ╬ ╬ ╬             ╬ ╬ ╬               ╬ ╬ ╬ ☼ ☼ ╬ ╬ ╬               ╬ ╬ ╬     ☼
☼     ╬ ╬ ╬               ╬ ╬ ╬     ╬ ╬ ╬               ╬ ╬ ╬             ╬ ╬ ╬               ╬ ╬ ╬     ╬ ╬ ╬               ╬ ╬ ╬             ╬ ╬ ╬               ╬ ╬ ╬     ╬ ╬ ╬               ╬ ╬ ╬     ☼
☼     ╬ ╬ ╬                                             ╬ ╬ ╬             ╬ ╬ ╬               ╬ ╬         ╬ ╬               ╬ ╬ ╬             ╬ ╬ ╬                                             ╬ ╬ ╬     ☼
☼     ╬ ╬ ╬       6                                       ╬ ╬ ╬         ╬ ╬ ╬                                                 ╬ ╬ ╬         ╬ ╬ ╬                                               ╬ ╬ ╬     ☼
☼     ╬ ╬ ╬                                               ╬ ╬ ╬         ╬ ╬ ╬                                                 ╬ ╬ ╬         ╬ ╬ ╬                                       2       ╬ ╬ ╬     ☼
☼                         ╬ ╬ ╬     ╬ ╬ ╬                                                     ╬ ╬ ╬     ╬ ╬ ╬                                                     ╬ ╬ ╬     ╬ ╬ ╬                         ☼
☼                         ╬ ╬ ╬     ╬ ╬ ╬                                                     ╬ ╬ ╬     ╬ ╬ ╬                                                     ╬ ╬ ╬     ╬ ╬ ╬                         ☼
☼           ╬ ╬ ╬ ╬       ╬ ╬ ╬     ╬ ╬ ╬     ╬ ╬ ╬ ╬             ☼ ☼           ╬ ╬ ╬ ╬                 □         ╬ ╬ ╬ ╬             ☼ ☼           ╬ ╬ ╬ ╬       ╬ ╬ ╬     ╬ ╬ ╬       ╬ ╬ ╬ ╬           ☼
☼ ☼ ☼       ╬ ╬ ╬ ╬                           ╬ ╬ ╬ ╬       □   ☼ ☼ ☼ ☼         ╬ ╬ ╬ ╬             □ □ □         ╬ ╬ ╬ ╬           ☼ ☼ ☼ ☼         ╬ ╬ ╬ ╬                             ╬ ╬ ╬ ╬       ☼ ☼ ☼
☼                                                           □ □   ☼ ☼           □               □ □ □                           □     ☼ ☼                     □                                           ☼
☼                         □ □ □                           □ □                     □ □ □         □ □                           □                             □ □                                           ☼
☼                           □ □ □             ╬ ╬ ╬       □ □                       □ □ □ □     □ □             □ □         □                   □           □ □ □                                         ☼
☼         ╬ ╬ ╬               □ □ □           ╬ ╬ ╬     □ □ □ □ □                       □ □ □ □ □ □           □ □         □ □                   □ □ □     □ □ □         □                   ╬ ╬ ╬         ☼
☼       ╬ ╬ ╬                   □ □           ╬ ╬ ╬     □ □ □ □ □ □                   □ □ □ □ □ □             □ □       □ □ □                   □ □ □ □   □ □           □ □ □ □     □ □       ╬ ╬ ╬       ☼
☼     ╬ ╬ ╬                       □           ╬ ╬ ╬     □ □ ╬ ╬ ╬ ╬ ╬ ╬             □ □ □ □ □ □ □ □ □ □ □ □ □ □ □       □ □ □           ╬         □ □ □     □ □           □ □ □ □ □ □           ╬ ╬ ╬     ☼
☼     ╬ ╬ ╬                       □ □         □ □ □ □ □ □ □ ╬ ╬ ╬ ╬ ╬ ╬ □ □ □ □       □ □ □ □ □ □ □ □ □ □ □ □ □         □ □ □         ╬ ╬ ╬       □ □ □ □   □             □ □ □   □ □           ╬ ╬ ╬     ☼
☼     ╬ ╬ ╬                         □ □ □ □ □ □ □ □ □ □ □ □ ╬ ╬ ╬ ╬ ╬ ╬ □ □ □ □ □ □     □ □ □ □ □ □ □ □ □ □ □           □ □ □ □     ╬ ╬ ╬ ╬ ╬       □ □ □ □ □           □ □                     ╬ ╬ ╬     ☼
☼     ╬ ╬ ╬           □               □ □ □ □ □ □ □ □ □ □ □ ╬ ╬ ╬ ╬ ╬ ╬ □ □ □ □ □ □ □         □ □ □ □ □ □               □ □ □ □ □ □ □ ╬ ╬ ╬ □ □     □ □ □ □ □         □ □ □                     ╬ ╬ ╬     ☼
☼   ╬ ╬ ╬             □ □               □ □ □         □ □ □ ╬ ╬ ╬ ╬ ╬ ╬ □ □ □ □ □ □                                   □ □ □ □ □ □ □ □ □ ╬ □ □ □ □ □ □ □ □ □ □ □ □ □ □ □ □ □                       ╬ ╬ ╬   ☼
☼ ╬ ╬ ╬                 □ □               □           □ □ □ □ □ □ □ □ □ □ □ □ □ □                 1                             □ □ □ □ □ □ □ □ □ □ □ □ □ □ □ □ □ □ □ □ □                   □       ╬ ╬ ╬ ☼
☼                       □ □ □                       □ □ □ □ □         □ □ □ □ □ □                             6                   □ □ □ □ □ □ □ □ □ □ □ □ □ □ □ □ □ □                       □ □           ☼
☼                       □ □ □             □                               □ □ □                             3              □        □       □ □ □ □ □ □ □ □ □ □ □ □ □ □                     □ □           ☼
☼                         □ □           □ □                   □ □                             4     7                     □ □ □                       □ □ □ □       □ □ □ □                 □ □ □ □       ☼
☼                         □ □ □ □       □ □ □ □         □ □ □ □ □                                               5       □ □ □ □ □ □                               □ □ □ □ □ □ □           □ □             ☼
☼                         □ □ □       □ □ □ □ □       □ □ □ ☼ ☼ ☼ ☼ ☼ ☼ ☼                           2                   □ □ □ □ ☼ ☼ ☼ ☼ ☼ ☼ ☼ ☼ □                 □ □ □ □ □ □ □                           ☼
☼                   □ □ □ □ □       □ □ □ □ □ □ □       □ □ ☼ ☼ ☼ ☼ ☼ ☼ ☼           □ □                                 □ □ □ □ ☼ ☼ ☼ ☼ ☼ ☼ ☼ ☼ □ □               □ □     □ □                             ☼
☼                   □ □ □         □ □ □ □ □ □ □ □       □ □ □ □ □ □ □ □ □       □ □ □               □ □ □               □ □ □ □ □ □ □ □ □ □ □ □ □               □ □         □ □                           ☼
ʘ   ¿         ¿                     □ □ □ □ □ □ □ □         □ □ □           □ □ □ □ □ □ □         □ □ □ □ □ □     □ □ □ □ □ □ □     □ □ □             ¿         □           □ □              ¿         ¿  ʘ
☼                         □ □ □     □ □ □ □   □ □ □ □                     □ □ □ □ □ □         □ □ □ □ □ □ □     □ □ □ □ □ □ □ □ □     □ □     ╬ ╬ ╬                                             ╬ ╬ ╬     ☼
☼     ╬ ╬ ╬           □ □ ╬ ╬ ╬     ╬ ╬ ╬     □ ╬ ╬ ╬       ╬ ╬ ╬         □ □ □ □         □ □ □ □ □ □ □ □ □ □     □ □ □         □ □     □     ╬ ╬ ╬       ╬ ╬ ╬                     ╬ ╬ ╬       ╬ ╬ ╬     ☼
☼     ╬ ╬ ╬               ╬ ╬ ╬     ╬ ╬ ╬     □ ╬ ╬ ╬       ╬ ╬ ╬       □ □ □ □         □ □ □ □ □ □ □ □ □ □ □       □ □                   □   ╬ ╬ ╬       ╬ ╬ ╬                     ╬ ╬ ╬       ╬ ╬ ╬     ☼
☼       ╬ ╬ ╬             ╬ ╬ ╬     ╬ ╬ ╬     □           ╬ ╬ ╬           ╬ ╬ ╬           □ □ □ □ □ □ □ □                   ╬ ╬ ╬             ╬ ╬ ╬       ╬ ╬ ╬                     ╬ ╬ ╬       ╬ ╬ ╬     ☼
☼       ╬ ╬ ╬             ╬ ╬ ╬ ☼ ☼ ╬ ╬ ╬       □         ╬ ╬ ╬           ╬ ╬ ╬                 □ □ □ □ □                   ╬ ╬ ╬             ╬ ╬ ╬     ╬ ╬ ╬                         ╬ ╬ ╬     ╬ ╬ ╬     ☼
☼         ╬ ╬ ╬           ╬ ╬ ╬ ☼ ☼ ╬ ╬ ╬               ╬ ╬ ╬           ╬ ╬ ╬                 ╬ ╬ ╬ ☼ ☼ ╬ ╬ ╬                 ╬ ╬ ╬           ╬ ╬ ╬     ╬ ╬ ╬                         ╬ ╬ ╬     ╬ ╬ ╬     ☼
☼         ╬ ╬ ╬           ╬ ╬ ╬ ☼ ☼ ╬ ╬ ╬               ╬ ╬ ╬           ╬ ╬ ╬         ╬ ╬     ╬ ╬ ╬ ☼ ☼ ╬ ╬ ╬     ╬ ╬         ╬ ╬ ╬           ╬ ╬ ╬     ╬ ╬ ╬     ╬ ╬ ╬ ╬ ╬ ╬ ╬ ╬     ╬ ╬ ╬     ╬ ╬ ╬     ☼
☼           ╬ ╬ ╬         ╬ ╬ ╬     ╬ ╬ ╬             ╬ ╬ ╬           ╬ ╬ ╬         ╬ ╬ ╬     ╬ ╬ ╬     ╬ ╬ ╬     ╬ ╬ ╬         ╬ ╬ ╬         ╬ ╬ ╬     ╬ ╬ ╬     ╬ ╬ ╬ ╬ ╬ ╬ ╬ ╬               ╬ ╬ ╬     ☼
☼           ╬ ╬ ╬         ╬ ╬ ╬     ╬ ╬ ╬   @ @       ╬ ╬ ╬         ╬ ╬ ╬           ╬ ╬ ╬     ╬ ╬ ╬     ╬ ╬ ╬     ╬ ╬ ╬           ╬ ╬ ╬       ╬ ╬ ╬                     ╬ ╬                     ╬ ╬ ╬     ☼
☼             ╬ ╬ ╬                         @ @     ╬ ╬ ╬           ╬ ╬ ╬           ╬ ╬ ╬ ╬ ╬ ╬ ╬ ╬     ╬ ╬ ╬ ╬ ╬ ╬ ╬ ╬           ╬ ╬ ╬                                 ╬ ╬                               ☼
☼             ╬ ╬ ╬                                 ╬ ╬ ╬           ╬ ╬ ╬           ╬ ╬ ╬ ╬ ╬                 ╬ ╬ ╬ ╬ ╬           ╬ ╬ ╬                                             @ @ @                 ☼
☼                         ╬ ╬ ╬     ╬ ╬ ╬                                     ╬ ╬ ╬ ╬                                 ╬ ╬ ╬ ╬                                                       @ @ @                 ☼
☼                         ╬ ╬ ╬     ╬ ╬ ╬                                       ╬ ╬ ╬                                 ╬ ╬ ╬                                                                               ☼
☼           ╬ ╬ ╬ ╬ ╬ ╬ ╬ ╬ ╬ ╬     ╬ ╬ ╬ ╬ ╬ ╬ ╬ ╬ ╬ ╬           ☼ ☼                                 7                               ☼ ☼           ╬ ╬ ╬ ╬ ╬ ╬ ╬ ╬ ╬ ╬     ╬ ╬ ╬ ╬ ╬ ╬ ╬ ╬ ╬ ╬           ☼
☼ ☼ ☼       ╬ ╬ ╬ ╬ ╬ ╬ ╬ ╬ ╬ ╬     ╬ ╬ ╬ ╬ ╬ ╬ ╬ ╬ ╬ ╬         ☼ ☼ ☼ ☼                                                             ☼ ☼ ☼ ☼         ╬ ╬ ╬ ╬ ╬ ╬ ╬ ╬ ╬ ╬     ╬ ╬ ╬ ╬ ╬ ╬ ╬ ╬ ╬ ╬       ☼ ☼ ☼
☼                                                                 ☼ ☼           ╬ ╬ ╬                                 ╬ ╬ ╬           ☼ ☼                         ╬ ╬ ╬     ╬ ╬ ╬                         ☼
☼                   @ @                                                       ╬ ╬ ╬ ╬                                 ╬ ╬ ╬ ╬                                     ╬ ╬ ╬     ╬ ╬ ╬                         ☼
☼                   @ @         ╬ ╬                                       ╬ ╬ ╬     ╬ ╬ ╬                         ╬ ╬ ╬     ╬ ╬ ╬                                                                 5       ☼
☼     ╬ ╬ ╬                     ╬ ╬                     ╬ ╬ ╬             ╬ ╬ ╬     ╬ ╬ ╬ ╬ ╬ ╬ ╬ ╬     ╬ ╬ ╬ ╬ ╬ ╬ ╬ ╬     ╬ ╬ ╬                 ╬ ╬ ╬                                 ╬ ╬ ╬             ☼
☼     ╬ ╬ ╬     ╬ ╬ ╬     ╬ ╬ ╬ ╬ ╬ ╬ ╬ ╬     ╬ ╬ ╬     ╬ ╬ ╬             ╬ ╬ ╬     ╬ ╬ ╬ ╬ ╬ ╬ ╬ ╬ ╬ ╬ ╬ ╬ ╬ ╬ ╬ ╬ ╬ ╬     ╬ ╬ ╬                 ╬ ╬ ╬                                 ╬ ╬ ╬             ☼
☼     ╬ ╬ ╬     ╬ ╬ ╬     ╬ ╬ ╬ ╬ ╬ ╬ ╬ ╬     ╬ ╬ ╬     ╬ ╬ ╬             ╬ ╬ ╬     ╬ ╬ ╬     ╬ ╬ ╬ ╬ ╬ ╬ ╬ ╬     ╬ ╬ ╬     ╬ ╬ ╬               ╬ ╬ ╬             ╬ ╬ ╬     ╬ ╬ ╬         ╬ ╬ ╬           ☼
☼     ╬ ╬ ╬     ╬ ╬ ╬         ☼ ☼ ☼ ☼         ╬ ╬ ╬     ╬ ╬ ╬             ╬ ╬ ╬     ╬ ╬ ╬     ╬ ╬ ╬     ╬ ╬ ╬     ╬ ╬ ╬     ╬ ╬ ╬               ╬ ╬ ╬             ╬ ╬ ╬     ╬ ╬ ╬         ╬ ╬ ╬           ☼
☼     ╬ ╬ ╬     ╬ ╬ ╬                         ╬ ╬ ╬     ╬ ╬ ╬                                                                                 ╬ ╬ ╬               ╬ ╬ ╬ ☼ ☼ ╬ ╬ ╬           ╬ ╬ ╬         ☼
☼     ╬ ╬ ╬       ╬ ╬ ╬                     ╬ ╬ ╬       ╬ ╬ ╬                                                                                 ╬ ╬ ╬               ╬ ╬ ╬ ☼ ☼ ╬ ╬ ╬           ╬ ╬ ╬         ☼
☼     ╬ ╬ ╬       ╬ ╬ ╬                     ╬ ╬ ╬       ╬ ╬ ╬             ╬ ╬ ╬                                             ╬ ╬ ╬           ╬ ╬ ╬                 ╬ ╬ ╬ ☼ ☼ ╬ ╬ ╬             ╬ ╬ ╬       ☼
☼       ╬ ╬ ╬     ╬ ╬ ╬     1               ╬ ╬ ╬     ╬ ╬ ╬               ╬ ╬ ╬               @ @ @                         ╬ ╬ ╬           ╬ ╬ ╬                 ╬ ╬ ╬     ╬ ╬ ╬             ╬ ╬ ╬       ☼
☼                 ╬ ╬ ╬ ☼                 ☼ ╬ ╬ ╬               @ @       ╬ ╬ ╬               @ @ @                         ╬ ╬ ╬         ╬ ╬ ╬       ╬ ╬ ╬       ╬ ╬ ╬     ╬ ╬ ╬               ╬ ╬ ╬     ☼
☼                   ╬ ╬ ╬ ☼             ☼ ╬ ╬ ╬               @ @ @       ╬ ╬ ╬               @ @ @                         ╬ ╬ ╬         ╬ ╬ ╬       ╬ ╬ ╬       ╬ ╬ ╬     ╬ ╬ ╬               ╬ ╬ ╬     ☼
☼                   ╬ ╬ ╬ ☼             ☼ ╬ ╬ ╬               @ @ @       ╬ ╬ ╬               @ @ @                         ╬ ╬ ╬                                                                         ☼
☼                   ☼ ☼ ☼ ☼             ☼ ☼ ☼ ☼                                                                                                                                       @ @ @               ☼
ʘ                                                                 ☼ ☼                                                                 ☼ ☼                                           @ @ @ @ @             ʘ
☼                             ☼ ╬ ╬ ☼                           ☼ ☼ ☼ ☼                                                             ☼ ☼ ☼ ☼                                           @ @ @               ☼
☼             ¿         ¿     ☼ ╬ ╬ ☼     ¿          ¿            ☼ ☼             ¿         ¿                 ¿          ¿            ☼ ☼             ¿         ¿                 ¿          ¿            ☼
☼               ☼ ☼ ☼ ☼       ☼ ╬ ╬ ☼       ☼ ☼ ☼ ☼                                                                                                                                                       ☼
☼               ☼ ☼ ☼ ☼         ☼ ☼         ☼ ☼ ☼ ☼                                           ╬ ╬ ╬     ╬ ╬ ╬               ╬ ╬ ╬         ╬ ╬ ╬         ╬ ╬ ╬     ╬ ╬ ╬     ╬ ╬ ╬     ╬ ╬ ╬     ╬ ╬ ╬     ☼
☼   ╬ ☼ ☼           ☼ ☼                     ☼ ☼           ☼ ☼ ╬ ╬ ╬ ╬ ╬ ╬ ╬ ☼ ☼               ╬ ╬ ╬     ╬ ╬ ╬     ╬ ╬ ╬     ╬ ╬ ╬         ╬ ╬ ╬         ╬ ╬ ╬     ╬ ╬ ╬     ╬ ╬ ╬     ╬ ╬ ╬     ╬ ╬ ╬     ☼
☼   ╬ ☼ ☼           ☼ ☼                     ☼ ☼           ☼ ☼ ╬ ╬ ╬ ╬ ╬ ╬ ╬ ☼ ☼               ╬ ╬ ╬     ╬ ╬ ╬     ╬ ╬ ╬     ╬ ╬ ╬         ╬ ╬ ╬         ╬ ╬ ╬     ☼ ☼ ╬     ╬ ☼ ☼     ╬ ╬ ╬   ‖ ╬ ╬ ╬     ☼
☼   ╬ ☼ ☼ ☼ ☼                                         ☼ ☼ ☼ ☼ ╬           ╬ ☼ ☼ ☼ ☼           ╬ ╬ ╬ ☼ ☼ ╬ ╬ ╬     ╬ ╬ ╬       ╬ ╬   ╬ ╬   ╬ ╬           ╬ ╬ ╬     ╬ ☼ ☼ ☼ ☼ ☼ ☼ ╬     ╬ ╬ ╬   ‖ ╬ ╬ ╬     ☼
☼     ╬ ╬ ☼ ☼     = =     ╬ ╬ ╬ ☼ ☼ ╬ ╬ ╬             ☼ ☼ ╬ ╬               ╬ ╬ ☼ ☼           ╬ ╬ ╬ ☼ ☼ ╬ ╬ ╬     ╬ ╬ ╬         ╬ ╬ ╬ ╬ ╬ ╬             ╬ ╬ ╬     ╬ ╬ ╬ ☼ ☼ ╬ ╬ ╬     ╬ ╬ ╬   ‖ ╬ ╬ ╬     ☼
☼                         ╬ ╬ ╬ ☼ ☼ ╬ ╬ ╬                         = = =                       ╬ ╬ ╬ ☼ ☼ ╬ ╬ ╬     ╬ ╬ ╬         ╬ ╬ ╬ ╬ ╬ ╬             ☼ ☼ ╬     ╬ ☼ ☼ ☼ ☼ ☼ ☼ ╬     ╬ ☼ ☼     ╬ ╬ ╬     ☼
☼               ╬ ╬ ╬     ╬ ╬ ╬     ╬ ╬ ╬     ╬ ╬ ╬                                           ╬ ╬ ╬     ╬ ╬ ╬     ╬ ╬ ╬       ╬ ╬   ╬ ╬   ╬ ╬           ╬ ☼ ☼     ☼ ☼ ╬     ╬ ☼ ☼     ☼ ☼ ╬     ╬ ╬ ╬     ☼
☼     ╬ ╬ ╬     ╬ ╬ ╬     ╬ ╬ ╬     ╬ ╬ ╬     ╬ ╬ ╬ ‖   ╬ ╬ ╬             ╬ ╬ ╬               ╬ ╬ ╬     ╬ ╬ ╬     ╬ ╬ ╬     ╬ ╬ ╬         ╬ ╬ ╬         ╬ ╬ ╬ ☼ ☼ ╬ ╬ ╬     ╬ ╬ ╬ ☼ ☼ ╬ ╬ ╬     ╬ ╬ ╬     ☼
☼     ╬ ╬ ╬     ╬ ╬ ╬                         ╬ ╬ ╬ ‖   ╬ ╬ ╬             ╬ ╬ ╬                                   ╬ ╬ ╬     ╬ ╬ ╬         ╬ ╬ ╬         ╬ ╬ ╬                         ╬ ╬ ╬     ╬ ╬ ╬     ☼
☼     ╬ ╬ ╬     ╬ ╬ ╬                         ╬ ╬ ╬     ╬ ╬ ╬             ╬ ╬ ╬       @ @                                   ╬ ╬ ╬         ╬ ╬ ╬         ╬ ╬ ╬                         ╬ ╬ ╬     ╬ ╬ ╬     ☼
☼                         ╬ ╬ ╬     ╬ ╬ ╬                                             @ @     ╬ ╬ ╬     ╬ ╬ ╬                                                     ╬ ╬ ╬     ╬ ╬ ╬                         ☼
☼                         ╬ ╬ ╬ ☼ ☼ ╬ ╬ ╬                                                     ╬ ╬ ╬     ╬ ╬ ╬                                                     ╬ ╬ ╬     ╬ ╬ ╬                         ☼
☼           ╬ ╬ ╬ ☼ ☼     ╬ ╬ ╬ ☼ ☼ ╬ ╬ ╬     ☼ ☼ ╬ ╬ ╬           ☼ ☼           ╬ ╬ ╬ ╬ ╬     ╬ ╬ ╬ ‖   ╬ ╬ ╬     ╬ ╬ ╬ ╬ ╬           ☼ ☼           ╬ ╬ ╬ ╬ ╬     ╬ ╬ ╬     ╬ ╬ ╬     ╬ ╬ ╬ ╬ ╬           ☼
☼ ☼ ☼       ╬ ╬ ╬ ☼ ☼     ╬ ╬ ╬     ╬ ╬ ╬     ☼ ☼ ╬ ╬ ╬         ☼ ☼ ☼ ☼         ╬ ╬ ╬ ╬ ╬           ‖             ╬ ╬ ╬ ╬ ╬         ☼ ☼ ☼ ☼         ╬ ╬ ╬ ╬ ╬                         ╬ ╬ ╬ ╬ ╬       ☼ ☼ ☼
☼                                                                 ☼ ☼           ╬ ╬ ╬                                 ╬ ╬ ╬           ☼ ☼                                 3           = =                 ☼
☼                                                                               ╬ ╬ ╬         ╬ ╬ ╬ ╬ ╬ ╬ ╬ ╬         ╬ ╬ ╬                                                                               ☼
☼     ╬ ╬ ╬     ╬ ╬ ╬     ╬ ╬ ╬     ╬ ╬ ╬     ╬ ╬ ╬     ╬ ╬ ╬             ╬         ╬ ╬ ╬     ╬ ╬ ╬ ╬ ╬ ╬ ╬ ╬     ╬ ╬ ╬         ╬             ╬ ╬ ╬     ╬ ╬ ╬     ╬ ╬ ╬     ╬ ╬ ╬     ╬ ╬ ╬     ╬ ╬ ╬     ☼
☼     ╬ ╬ ╬     ╬ ╬ ╬     ╬ ╬ ╬ ☼ ☼ ╬ ╬ ╬     ╬ ╬ ╬     ╬ ╬ ╬     4       ╬ ╬       ╬ ╬ ╬     ╬ ╬ ╬     ╬ ╬ ╬     ╬ ╬ ╬       ╬ ╬     = = =   ╬ ╬ ╬     ╬ ╬ ╬     ╬ ╬ ╬     ╬ ╬ ╬     ╬ ╬ ╬     ╬ ╬ ╬     ☼
☼     ╬ ╬ ╬     ╬ ╬ ╬     ╬ ╬ ╬ ☼ ☼ ╬ ╬ ╬     ╬ ╬ ╬     ╬ ╬ ╬             ╬ ╬ ╬     ╬ ╬ ╬     ╬ ╬ ╬ ╬ ╬ ╬ ╬ ╬     ╬ ╬ ╬     ╬ ╬ ╬     ‖       ╬ ╬ ╬     ╬ ╬ ╬     ╬ ╬ ╬ ╬ ╬ ╬ ╬ ╬     ╬ ╬ ╬     ╬ ╬ ╬     ☼
☼  ‖  ╬ ╬ ╬     ╬ ╬ ╬                         ╬ ╬ ╬     ╬ ╬ ╬   = =       ╬ ╬ ╬     ╬ ╬ ╬     ╬ ╬ ╬ ╬ ╬ ╬ ╬ ╬     ╬ ╬ ╬     ╬ ╬ ╬     ‖       ╬ ╬ ╬     ╬ ╬ ╬ ╬ ╬ ╬ ╬ ╬ ╬ ╬ ╬ ╬ ╬ ╬ ╬ ╬ ╬ ╬     ╬ ╬ ╬   ‖ ☼
☼  ‖  ╬ ╬ ╬   ☼ ☼ ╬ ╬                         ╬ ╬ ☼ ☼   ╬ ╬ ╬             ╬ ╬ ╬                                             ╬ ╬ ╬     ‖       ╬ ╬ ╬     ╬ ╬ ╬ ╬ ╬ ╬ ╬ ╬     ╬ ╬ ╬ ╬ ╬ ╬ ╬ ╬     ╬ ╬ ╬   ‖ ☼
☼  ‖  ╬ ╬ ╬   ☼ ☼ ╬ ╬     ╬ ╬ ╬     ╬ ╬ ╬     ╬ ╬ ☼ ☼   ╬ ╬ ╬             ╬ ╬ ╬                                             ╬ ╬ ╬             ╬ ╬ ╬     ╬ ╬ ╬                         ╬ ╬ ╬     ╬ ╬ ╬   ‖ ☼
ʘ     ╬ ╬ ╬     ╬ ╬ ╬     ╬ ╬ ╬ ☼ ☼ ╬ ╬ ╬     ╬ ╬ ╬     ╬ ╬ ╬ ╬ ╬ ╬ ╬ ╬ ╬ ╬ ╬ ╬             ‖ ╬ ╬ ╬ ╬ ╬ ╬ ╬ ╬               ╬ ╬ ╬ ╬ ╬ ╬ ╬ ╬ ╬ ╬ ╬ ╬     ╬ ╬                             ╬ ╬     ╬ ╬ ╬     ʘ
☼     ╬ ╬ ╬     ╬ ╬ ╬     ╬ ╬ ╬ ☼ ☼ ╬ ╬ ╬     ╬ ╬ ╬     ╬ ╬ ╬ ╬ ╬ ╬ ╬ ╬ ╬ ╬         ╬ ╬ ╬   ‖ ╬ ╬ ╬ ╬ ╬ ╬ ╬ ╬     ╬ ╬ ╬         ╬ ╬ ╬ ╬ ╬ ╬ ╬ ╬ ╬ ╬     ╬                                 ╬     ╬ ╬ ╬     ☼
☼     ╬ ╬ ╬               ╬ ╬ ╬     ╬ ╬ ╬               ╬ ╬ ╬                       ╬ ╬ ╬   ‖                     ╬ ╬ ╬                       ╬ ╬ ╬                     ╬ ╬ ╬                   ╬ ╬ ╬     ☼
☼     ╬ ╬ ╬                                             ╬ ╬ ╬                     ╬ ╬ ╬                             ╬ ╬ ╬                     ╬ ╬ ╬                     ╬ ╬ ╬                   ╬ ╬ ╬     ☼
☼     ╬ ╬ ╬                                             ╬ ╬ ╬             ╬ ╬ ╬ ╬ ╬ ╬                               ╬ ╬ ╬                     ╬ ╬ ╬       = = =         ╬ ╬ ╬                   ╬ ╬ ╬     ☼
☼                         ╬ ╬ ╬     ╬ ╬ ╬                                 ╬ ╬ ╬ ╬ ╬ ╬             ╬ ╬ ╬ ╬             ╬ ╬ ╬ ╬ ╬ ╬             ╬ ╬ ╬                                             ╬ ╬ ╬     ☼
☼     = = =               ╬ ╬ ╬ ☼ ☼ ╬ ╬ ╬                                                         ╬ ╬ ╬ ╬             ╬ ╬ ╬ ╬ ╬ ╬                                 = = =                                   ☼
☼                         ╬ ╬ ╬     ╬ ╬ ╬                                                                                                                                                                 ☼
☼                                                               ☼ ☼ ☼ ☼                                                             ☼ ☼ ☼ ☼                                                               ☼
☼ ☼ ☼ ☼ ☼ ☼ ☼ ☼ ☼ ☼ ☼ ☼ ☼ ʘ ☼ ☼ ☼ ☼ ☼ ☼ ☼ ☼ ☼ ☼ ☼ ☼ ☼ ☼ ☼ ☼ ☼ ☼ ☼ ☼ ☼ ☼ ☼ ☼ ☼ ☼ ☼ ☼ ☼ ☼ ☼ ☼ ☼ ☼ ☼ ☼ ʘ ☼ ☼ ☼ ☼ ☼ ☼ ☼ ☼ ☼ ☼ ☼ ☼ ☼ ☼ ☼ ☼ ☼ ☼ ☼ ☼ ☼ ☼ ☼ ☼ ☼ ☼ ☼ ☼ ☼ ☼ ☼ ☼ ☼ ☼ ☼ ʘ ☼ ☼ ☼ ☼ ☼ ☼ ☼ ☼ ☼ ☼ ☼ ☼ ☼ ☼ ☼