☼ ☼ ☼ ☼ ☼ ☼ ☼ ☼ ʘ ☼ ☼ ☼ ☼ ☼ ☼ ☼ ☼ ☼ ☼ ☼ ☼ ☼ ☼ ☼ ☼ ☼ ☼ ☼ ☼ ☼ ☼ ☼ ☼ ☼ ☼ ☼ ☼ ☼ ☼ ☼ ☼ ☼ ʘ ☼ ☼ ☼ ☼ ☼ ☼ ☼ ☼ ☼ ☼ ☼ ☼ ☼ ☼ ☼ ☼ ☼ ☼ ☼ ☼ ☼ ☼ ☼ ☼ ☼ ☼ ☼ ☼ ☼ ☼ ☼ ☼ ☼ ☼ ☼ ☼ ☼ ☼ ☼ ☼ ☼ ☼ ☼ ☼ ☼ ☼ ☼ ☼ ☼ ☼ ☼ ☼ ☼ ☼ ☼ ☼ ☼
☼                           1         2                                                         1     ʘ                                                         ʘ         ʘ                           ☼
☼                                □                                                                                                                                   □                                ☼
☼     ╬ ╬ ╬               ╬ ╬ ╬               ╬ ╬ ╬     ╬ ╬ ╬               ╬ ╬ ╬   ╬ ╬ ╬     ╬ ╬ ╬ ╬ ╬ ╬     ╬ ╬ ╬   ╬ ╬ ╬               ╬ ╬ ╬     ╬ ╬ ╬               ╬ ╬ ╬               ╬ ╬ ╬     ☼
☼     1                   ╬ ╬ ╬               ╬ ╬ ╬     1 ╬ ╬ ╬           ╬ ╬ ╬ 1             ╬ ╬ ╬ ╬ ╬ ╬             ʘ ╬ ╬ ╬           ╬ ╬ ╬ ʘ     ╬ ╬ ╬               ╬ ╬ ╬                   ʘ     ☼
☼     ╬ ╬ ╬               ╬ ╬ ╬               ╬ ╬ ╬         ╬ ╬ ╬       ╬ ╬ ╬                 ╬ ╬ ╬ ╬ ╬ ╬                 ╬ ╬ ╬       ╬ ╬ ╬         ╬ ╬ ╬               ╬ ╬ ╬               ╬ ╬ ╬     ☼
☼     ╬ ╬ ╬     ╬ ╬ ╬     ╬ ╬ ╬               ╬ ╬ ╬           ╬ ╬ ╬   ╬ ╬ ╬         ╬ ╬ ╬     ╬ ╬ ╬ ╬ ╬ ╬     ╬ ╬ ╬         ╬ ╬ ╬   ╬ ╬ ╬           ╬ ╬ ╬               ╬ ╬ ╬     ╬ ╬ ╬     ╬ ╬ ╬     ☼
☼     ╬ ╬ ╬     ╬ ╬ ╬     ╬ ╬ ╬     ╬ ╬ ╬     ╬ ╬ ╬             ╬ ╬ ╬ ╬ ╬                     ╬ ╬ ╬ ╬ ╬ ╬                     ╬ ╬ ╬ ╬ ╬             ╬ ╬ ╬     ╬ ╬ ╬     ╬ ╬ ╬     ╬ ╬ ╬     ╬ ╬ ╬     ☼
☼     ╬ ╬ ╬     ╬ ╬ ╬     ╬ ╬ ╬     ╬ ╬ ╬     ╬ ╬ ╬               ╬ ╬ ╬             ╬ ╬ ╬     ╬ ╬ ╬ ╬ ╬ ╬     ╬ ╬ ╬             ╬ ╬ ╬               ╬ ╬ ╬     ╬ ╬ ╬     ╬ ╬ ╬     ╬ ╬ ╬     ╬ ╬ ╬     ☼
☼ ‖   ╬ ╬ ╬     ╬ ╬ ╬     ╬ ╬ ╬     ╬ ╬ ╬     ╬ ╬ ╬                 ╬                         ╬ ╬ ╬ ╬ ╬ ╬                         ╬                 ╬ ╬ ╬     ╬ ╬ ╬     ╬ ╬ ╬     ╬ ╬ ╬     ╬ ╬ ╬   ‖ ☼
☼ ‖   ╬ ╬ ╬     ╬ ╬ ╬     ╬ ╬ ╬     ╬ ╬ ╬     ╬ ╬ ╬                 ‖                         ╬ ╬ ╬ ╬ ╬ ╬                         ‖                 ╬ ╬ ╬     ╬ ╬ ╬     ╬ ╬ ╬     ╬ ╬ ╬     ╬ ╬ ╬   ‖ ☼
☼     ╬ ╬ ╬     ╬ ╬ ╬               ╬ ╬ ╬     ╬ ╬ ╬                 ‖                                                             ‖                 ╬ ╬ ╬     ╬ ╬ ╬               ╬ ╬ ╬     ╬ ╬ ╬     ☼
☼     ╬ ╬ ╬     ╬ ╬ ╬               ╬ ╬ ╬     ╬ ╬ ╬                 ‖     ╬ ╬ ╬     ╬ ╬ ╬                     ╬ ╬ ╬     ╬ ╬ ╬     ‖                 ╬ ╬ ╬     ╬ ╬ ╬               ╬ ╬ ╬     ╬ ╬ ╬     ☼
☼               ╬ ╬ ╬               ╬ ╬ ╬          = =                                        ╬ ╬ ╬ ╬ ╬ ╬                                                     ╬ ╬ ╬               ╬ ╬ ╬               ☼
☼                    = =           2╬ ╬ ╬                                                     ╬ ╬ ╬ ╬ ╬ ╬                                                     ╬ ╬ ╬2           = =                    ☼
☼           ╬ ╬ ╬ ╬ ╬               ╬ ╬ ╬     ╬ ╬ ╬ ╬ ╬           ╬ ╬           ╬ ╬ ╬ ╬ ╬     ╬ ╬ ╬ ╬ ╬ ╬     ╬ ╬ ╬ ╬ ╬           ╬ ╬           ╬ ╬ ╬ ╬ ╬     ╬ ╬ ╬               ╬ ╬ ╬ ╬ ╬           ☼
☼ ☼ ☼       ╬ ╬ ╬ ╬ ╬                         ╬ ╬ ╬ ╬ ╬       ☼ ☼ ☼ ☼ ☼ ☼       ╬ ╬ ╬ ╬ ╬                     ╬ ╬ ╬ ╬ ╬       ☼ ☼ ☼ ☼ ☼ ☼       ╬ ╬ ╬ ╬ ╬                         ╬ ╬ ╬ ╬ ╬       ☼ ☼ ☼
☼                                                                 ╬ ╬                                                             ╬ ╬                                                                 ☼
☼                        ╬ ╬ ╬     ╬ ╬ ╬                          1 ╬                        ╬ ╬                                  ╬ ʘ                                                                 ☼
☼     ╬ ╬ ╬     ╬ ╬ ╬     ╬ ╬ ╬     ╬ ╬ ╬     ╬ ╬ ╬     ╬ ╬ ╬     ╬ ╬     ╬ ╬ ╬     ╬ ╬ ╬     ╬ ╬ ╬ ╬ ╬ ╬     ╬ ╬ ╬     ╬ ╬ ╬     ╬ ╬     ╬ ╬ ╬     ╬ ╬ ╬     ╬ ╬ ╬     ╬ ╬ ╬     ╬ ╬ ╬     ╬ ╬ ╬     ☼
☼     ╬ ╬ ╬     ╬ ╬ ╬     ╬ ╬ ╬     ╬ ╬ ╬     ╬ ╬ ╬     ╬ ╬ ╬     ╬ ╬     ╬ ╬ ╬     ╬ ╬ ╬     ╬ ╬ ╬ ╬ ╬ ╬     ╬ ╬ ╬     ╬ ╬ ╬     ╬ ╬     ╬ ╬ ╬     ╬ ╬ ╬     ╬ ╬ ╬     ╬ ╬ ╬     ╬ ╬ ╬     ╬ ╬ ╬     ☼
☼     ╬ ╬ ╬     ╬ ╬ ╬     ╬ ╬ ╬ ╬ ╬ ╬ ╬ ╬     ╬ ╬ ╬     ╬ ╬ ╬     ╬ ╬     ╬ ╬ ╬     ╬ ╬ ╬     ╬ ╬ ╬ ╬ ╬ ╬     ╬ ╬ ╬     ╬ ╬ ╬     ╬ ╬     ╬ ╬ ╬     ╬ ╬ ╬     ╬ ╬ ╬ ╬ ╬ ╬ ╬ ╬     ╬ ╬ ╬     ╬ ╬ ╬     ☼
☼     ╬ ╬ ╬     ╬ ╬ ╬     ╬ ╬ ╬ ╬ ╬ ╬ ╬ ╬     ╬ ╬ ╬     ╬ ╬ ╬     ╬ ╬     ╬ ╬ ╬     ╬ ╬ ╬     ╬ ╬ ╬ ╬ ╬ ╬     ╬ ╬ ╬     ╬ ╬ ╬     ╬ ╬     ╬ ╬ ╬     ╬ ╬ ╬     ╬ ╬ ╬ ╬ ╬ ╬ ╬ ╬     ╬ ╬ ╬     ╬ ╬ ╬     ☼
☼     ╬ ╬ ╬     ╬ ╬ ╬     ╬ ╬ ╬     ╬ ╬ ╬     ╬ ╬ ╬     ╬ ╬ ╬     ╬ ╬     ╬ ╬ ╬     ╬ ╬ ╬     ╬ ╬ ╬ ╬ ╬ ╬     ╬ ╬ ╬     ╬ ╬ ╬     ╬ ╬     ╬ ╬ ╬     ╬ ╬ ╬     ╬ ╬ ╬     ╬ ╬ ╬     ╬ ╬ ╬     ╬ ╬ ╬     ☼
☼     ╬ ╬ ╬     ╬ ╬ ╬     ╬ ╬ ╬     ╬ ╬ ╬     ╬ ╬ ╬     ╬ ╬ ╬     ╬ ╬     ╬ ╬ ╬     ╬ ╬ ╬     ╬ ╬ ╬ ╬ ╬ ╬     ╬ ╬ ╬     ╬ ╬ ╬     ╬ ╬     ╬ ╬ ╬     ╬ ╬ ╬     ╬ ╬ ╬     ╬ ╬ ╬     ╬ ╬ ╬     ╬ ╬ ╬     ☼
☼     ╬ ╬ ╬     ╬ ╬ ╬     ╬ ╬ ╬     ╬ ╬ ╬     ╬ ╬ ╬     ╬ ╬ ╬     ╬ ╬     ╬ ╬ ╬     ╬ ╬ ╬     ╬ ╬ ╬ ╬ ╬ ╬     ╬ ╬ ╬     ╬ ╬ ╬     ╬ ╬     ╬ ╬ ╬     ╬ ╬ ╬     ╬ ╬ ╬     ╬ ╬ ╬     ╬ ╬ ╬     ╬ ╬ ╬     ☼
☼     ╬ ╬ ╬     ╬ ╬ ╬     ╬ ╬ ╬     ╬ ╬ ╬     ╬ ╬ ╬     ╬ ╬ ╬     ╬ ╬     ╬ ╬ ╬     ╬ ╬ ╬     ╬ ╬ ╬ ╬ ╬ ╬     ╬ ╬ ╬     ╬ ╬ ╬     ╬ ╬     ╬ ╬ ╬     ╬ ╬ ╬     ╬ ╬ ╬     ╬ ╬ ╬     ╬ ╬ ╬     ╬ ╬ ╬     ☼
☼     ╬ ╬ ╬                                             ╬ ╬ ╬     ╬ ╬     ╬ ╬ ╬                                         ╬ ╬ ╬     ╬ ╬     ╬ ╬ ╬                                             ╬ ╬ ╬     ☼
☼     ╬ ╬ ╬                                             ╬ ╬ ╬     ╬ ╬     ╬ ╬ ╬                                         ╬ ╬ ╬     ╬ ╬     ╬ ╬ ╬                                             ╬ ╬ ╬     ☼
☼     ╬ ╬ ╬               ╬ ╬ ╬ ╬ ╬ ╬ ╬ ╬               ╬ ╬ ╬     ╬ ╬     ╬ ╬ ╬               ╬ ╬ ╬ ╬ ╬ ╬               ╬ ╬ ╬     ╬ ╬     ╬ ╬ ╬               ╬ ╬ ╬ ╬ ╬ ╬ ╬ ╬               ╬ ╬ ╬     ☼
☼   1 ╬ ╬ ╬               ╬ ╬ ╬ ╬ ╬ ╬ ╬ ╬               ╬ ╬ ╬ 1   ╬ ╬   1 ╬ ╬ ╬               ╬ ╬ ╬ ╬ ╬ ╬               ╬ ╬ ╬ ʘ   ╬ ╬   ʘ ╬ ╬ ╬               ╬ ╬ ╬ ╬ ╬ ╬ ╬ ╬               ╬ ╬ ╬ ʘ   ☼
☼                         ╬ ╬         ╬ ╬                         ╬ ╬                         ╬ ╬ ╬ ╬ ╬ ╬                         ╬ ╬                         ╬ ╬         ╬ ╬                         ☼
☼                         ╬ ╬   2     ╬ ╬                         ╬ ╬                         ╬ ╬ ╬ ╬ ╬ ╬                         ╬ ╬                         ╬ ╬     ʘ   ╬ ╬                         ☼
☼     ╬ ╬ ╬   ╬ ʘ ╬ ╬ ╬ ╬ ╬ ╬         ╬ ╬ ╬ ╬ ╬                   ╬ ╬     ╬ ╬ ╬     ʘ ╬ ╬ ╬ ☼ ╬ ╬ ╬ ╬ ╬ ╬ ☼ ╬ ╬ ╬ ʘ     ╬ ╬ ╬     ╬ ╬                   ╬ ╬ ╬ ╬ ╬         ╬ ╬ ╬ ╬ ╬ ╬ ʘ ╬   ╬ ╬ ╬     ☼
☼     ╬ ╬ ╬   ╬ ╬ ╬ ╬ ╬ ╬ ╬ ╬ ╬ ╬ ╬ ╬ ╬ ╬ ╬ ╬ ╬                   ╬ ╬               ╬ ╬ ╬ ╬ ╬ ╬ ╬ ╬ ╬ ╬ ╬ ╬ ╬ ╬ ╬ ╬               ╬ ╬                   ╬ ╬ ╬ ╬ ╬ ╬ ╬ ╬ ╬ ╬ ╬ ╬ ╬ ╬ ╬ ╬ ╬   ╬ ╬ ╬     ☼
☼                           1         2                           ╬ ╬                           1     ʘ                           ╬ ╬                           ʘ         ʘ                           ☼
☼                                □                                ╬ ╬                                                             ╬ ╬                                □                                ☼
☼     ╬ ╬ ╬     ╬ ╬ ╬     ╬ ╬ ╬     ╬ ╬ ╬     ╬ ╬ ╬     ╬ ╬ ╬     ╬ ╬     ╬ ╬ ╬     ╬ ╬ ╬     ╬ ╬ ╬ ╬ ╬ ╬     ╬ ╬ ╬     ╬ ╬ ╬     ╬ ╬     ╬ ╬ ╬     ╬ ╬ ╬     ╬ ╬ ╬     ╬ ╬ ╬     ╬ ╬ ╬     ╬ ╬ ╬     ☼
☼     1                   ╬ ╬ ╬     ╬ ╬ ╬     ╬ ╬ ╬     1         ╬ ╬     1                   ╬ ╬ ╬ ╬ ╬ ╬                   ʘ     ╬ ╬         ʘ     ╬ ╬ ╬     ╬ ╬ ╬     ╬ ╬ ╬                   ʘ     ☼
☼                         ╬ ╬ ╬     ╬ ╬ ╬     ╬ ╬ ╬               ╬ ╬                         ╬ ╬ ╬ ╬ ╬ ╬                         ╬ ╬               ╬ ╬ ╬     ╬ ╬ ╬     ╬ ╬ ╬                         ☼
☼               ╬ ╬ ╬     ╬ ╬ ╬     ╬ ╬ ╬     ╬ ╬ ╬       ╬ ╬ ╬   ╬ ╬               ╬ ╬ ╬     ╬ ╬ ╬ ╬ ╬ ╬     ╬ ╬ ╬               ╬ ╬   ╬ ╬ ╬       ╬ ╬ ╬     ╬ ╬ ╬     ╬ ╬ ╬     ╬ ╬ ╬               ☼
☼          ‖              ╬ ╬ ╬     ╬ ╬ ╬     ╬ ╬ ╬                                           ╬ ╬ ╬ ╬ ╬ ╬                                           ╬ ╬ ╬     ╬ ╬ ╬     ╬ ╬ ╬                         ☼
☼          ‖    ╬ ╬ ╬     ╬ ╬ ╬     ╬ ╬ ╬     ╬ ╬ ╬               ☼                 ╬ ╬ ╬     ╬ ╬ ╬ ╬ ╬ ╬     ╬ ╬ ╬                 ☼               ╬ ╬ ╬     ╬ ╬ ╬     ╬ ╬ ╬     ╬ ╬ ╬               ☼
☼                         ╬ ╬ ╬     ╬ ╬ ╬     ╬ ╬ ╬          ╬ ╬ ╬☼   ‖                       ╬ ╬ ╬ ╬ ╬ ╬                       ‖   ☼               ╬ ╬ ╬     ╬ ╬ ╬     ╬ ╬ ╬                         ☼
☼                         ╬ ╬ ╬     ╬ ╬ ╬     ╬ ╬ ╬               ☼   ‖                       ╬ ╬ ╬ ╬ ╬ ╬                       ‖   ☼               ╬ ╬ ╬     ╬ ╬ ╬     ╬ ╬ ╬                         ☼
☼                                             ╬ ╬ ╬               ☼                                                                 ☼               ╬ ╬ ╬                                             ☼
☼     ╬ ╬ ╬     ╬ ╬ ╬                         ╬ ╬ ╬               ☼       ╬ ╬ ╬     ╬ ╬ ╬                     ╬ ╬ ╬     ╬ ╬ ╬       ☼               ╬ ╬ ╬                         ╬ ╬ ╬     ╬ ╬ ╬     ☼
☼                         ╬ ╬ ╬     ╬ ╬ ╬                         ☼                           ╬ ╬ ╬ ╬ ╬ ╬                           ☼                         ╬ ╬ ╬     ╬ ╬ ╬                         ☼
☼                         ╬ ╬ ╬ 2   ╬ ╬ ╬                         ☼                           ╬ ╬ ╬ ╬ ╬ ╬                           ☼                         ╬ ╬ ╬   ʘ ╬ ╬ ╬                         ☼
☼ ☼ ☼ ☼     ╬ ╬ ╬ ╬ ╬     ╬ ╬ ╬     ╬ ╬ ╬     ╬ ╬ ╬ ╬ ╬           ☼             ╬ ╬ ╬ ╬ ╬     ╬ ╬ ╬ ╬ ╬ ╬     ╬ ╬ ╬ ╬ ╬             ☼           ╬ ╬ ╬ ╬ ╬     ╬ ╬ ╬     ╬ ╬ ╬     ╬ ╬ ╬ ╬ ╬     ☼ ☼ ☼ ☼
☼ ☼ ☼ ☼     ╬ ╬ ╬ ╬ ╬     ╬ ╬ ╬     ╬ ╬ ╬     ╬ ╬ ╬ ╬ ╬           ☼             ╬ ╬ ╬ ╬ ╬     ╬ ╬ ╬ ╬ ╬ ╬     ╬ ╬ ╬ ╬ ╬             ☼           ╬ ╬ ╬ ╬ ╬     ╬ ╬ ╬     ╬ ╬ ╬     ╬ ╬ ╬ ╬ ╬     ☼ ☼ ☼ ☼
☼                         ╬ ╬ ╬ ʘ   ╬ ╬ ╬                         ☼                           ╬ ╬ ╬ ╬ ╬ ╬                           ☼                         ╬ ╬ ╬   ʘ ╬ ╬ ╬                         ☼
☼                         ╬ ╬ ╬     ╬ ╬ ╬                         ☼                           ╬ ╬ ╬ ╬ ╬ ╬                           ☼                         ╬ ╬ ╬     ╬ ╬ ╬                         ☼
☼     ╬ ╬ ╬     ╬ ╬ ╬                         ╬ ╬ ╬               ☼       ╬ ╬ ╬     ╬ ╬ ╬                     ╬ ╬ ╬     ╬ ╬ ╬       ☼               ╬ ╬ ╬                         ╬ ╬ ╬     ╬ ╬ ╬     ☼
☼                                             ╬ ╬ ╬               ☼                                                                 ☼               ╬ ╬ ╬                                             ☼
☼                         ╬ ╬ ╬     ╬ ╬ ╬     ╬ ╬ ╬               ☼   ‖                       ╬ ╬ ╬ ╬ ╬ ╬                       ‖   ☼               ╬ ╬ ╬     ╬ ╬ ╬     ╬ ╬ ╬                         ☼
☼                         ╬ ╬ ╬     ╬ ╬ ╬     ╬ ╬ ╬               ☼   ‖                       ╬ ╬ ╬ ╬ ╬ ╬                       ‖   ☼               ╬ ╬ ╬     ╬ ╬ ╬     ╬ ╬ ╬                         ☼
☼               ╬ ╬ ╬     ╬ ╬ ╬     ╬ ╬ ╬     ╬ ╬ ╬               ☼                 ╬ ╬ ╬     ╬ ╬ ╬ ╬ ╬ ╬     ╬ ╬ ╬                 ☼               ╬ ╬ ╬     ╬ ╬ ╬     ╬ ╬ ╬     ╬ ╬ ╬               ☼
☼                         ╬ ╬ ╬     ╬ ╬ ╬     ╬ ╬ ╬                                           ╬ ╬ ╬ ╬ ╬ ╬                                           ╬ ╬ ╬     ╬ ╬ ╬     ╬ ╬ ╬                         ☼
☼               ╬ ╬ ╬     ╬ ╬ ╬     ╬ ╬ ╬     ╬ ╬ ╬       ╬ ╬ ╬   ╬ ╬               ╬ ╬ ╬     ╬ ╬ ╬ ╬ ╬ ╬     ╬ ╬ ╬               ╬ ╬   ╬ ╬ ╬       ╬ ╬ ╬     ╬ ╬ ╬     ╬ ╬ ╬     ╬ ╬ ╬               ☼
☼                         ╬ ╬ ╬     ╬ ╬ ╬     ╬ ╬ ╬               ╬ ╬                         ╬ ╬ ╬ ╬ ╬ ╬                         ╬ ╬               ╬ ╬ ╬     ╬ ╬ ╬     ╬ ╬ ╬                         ☼
☼     ʘ                   ╬ ╬ ╬     ╬ ╬ ╬     ╬ ╬ ╬     ʘ         ╬ ╬     ʘ                   ╬ ╬ ╬ ╬ ╬ ╬                   ʘ     ╬ ╬         ʘ     ╬ ╬ ╬     ╬ ╬ ╬     ╬ ╬ ╬                   ʘ     ☼
☼     ╬ ╬ ╬     ╬ ╬ ╬     ╬ ╬ ╬     ╬ ╬ ╬     ╬ ╬ ╬     ╬ ╬ ╬     ╬ ╬     ╬ ╬ ╬     ╬ ╬ ╬     ╬ ╬ ╬ ╬ ╬ ╬     ╬ ╬ ╬     ╬ ╬ ╬     ╬ ╬     ╬ ╬ ╬     ╬ ╬ ╬     ╬ ╬ ╬     ╬ ╬ ╬     ╬ ╬ ╬     ╬ ╬ ╬     ☼
☼                                                                 ╬ ╬                                                             ╬ ╬                                                                 ☼
☼                           ʘ         ʘ                           ╬ ╬                           ʘ     ʘ                           ╬ ╬                           ʘ         ʘ                           ☼
☼     ╬ ╬ ╬   ╬ ╬ ╬ ╬ ╬ ╬ ╬ ╬ ╬ ╬ ╬ ╬ ╬ ╬ ╬ ╬ ╬                   ╬ ╬               ╬ ╬ ╬ ╬ ╬ ╬ ╬ ╬ ╬ ╬ ╬ ╬ ╬ ╬ ╬ ╬               ╬ ╬                   ╬ ╬ ╬ ╬ ╬ ╬ ╬ ╬ ╬ ╬ ╬ ╬ ╬ ╬ ╬ ╬ ╬   ╬ ╬ ╬     ☼
☼     ╬ ╬ ╬   ╬ ʘ ╬ ╬ ╬ ╬ ╬ ╬         ╬ ╬ ╬ ╬ ╬                   ╬ ╬     ╬ ╬ ╬     ʘ ╬ ╬ ╬ ☼ ╬ ╬ ╬ ╬ ╬ ╬ ☼ ╬ ╬ ╬ ʘ     ╬ ╬ ╬     ╬ ╬                   ╬ ╬ ╬ ╬ ╬         ╬ ╬ ╬ ╬ ╬ ╬ ʘ ╬   ╬ ╬ ╬     ☼
☼                         ╬ ╬   ʘ     ╬ ╬                         ╬ ╬                         ╬ ╬ ╬ ╬ ╬ ╬                         ╬ ╬                         ╬ ╬     ʘ   ╬ ╬                         ☼
☼                         ╬ ╬         ╬ ╬                         ╬ ╬                         ╬ ╬ ╬ ╬ ╬ ╬                         ╬ ╬                         ╬ ╬         ╬ ╬                         ☼
☼   ʘ ╬ ╬ ╬               ╬ ╬ ╬ ╬ ╬ ╬ ╬ ╬               ╬ ╬ ╬ ʘ   ╬ ╬   ʘ ╬ ╬ ╬               ╬ ╬ ╬ ╬ ╬ ╬               ╬ ╬ ╬ ʘ   ╬ ╬   ʘ ╬ ╬ ╬               ╬ ╬ ╬ ╬ ╬ ╬ ╬ ╬               ╬ ╬ ╬ ʘ   ☼
☼     ╬ ╬ ╬               ╬ ╬ ╬ ╬ ╬ ╬ ╬ ╬               ╬ ╬ ╬     ╬ ╬     ╬ ╬ ╬               ╬ ╬ ╬ ╬ ╬ ╬               ╬ ╬ ╬     ╬ ╬     ╬ ╬ ╬               ╬ ╬ ╬ ╬ ╬ ╬ ╬ ╬               ╬ ╬ ╬     ☼
☼     ╬ ╬ ╬                                             ╬ ╬ ╬     ╬ ╬     ╬ ╬ ╬                                         ╬ ╬ ╬     ╬ ╬     ╬ ╬ ╬                                             ╬ ╬ ╬     ☼
☼     ╬ ╬ ╬                                             ╬ ╬ ╬     ╬ ╬     ╬ ╬ ╬                                         ╬ ╬ ╬     ╬ ╬     ╬ ╬ ╬                                             ╬ ╬ ╬     ☼
☼     ╬ ╬ ╬     ╬ ╬ ╬     ╬ ╬ ╬     ╬ ╬ ╬     ╬ ╬ ╬     ╬ ╬ ╬     ╬ ╬     ╬ ╬ ╬     ╬ ╬ ╬     ╬ ╬ ╬ ╬ ╬ ╬     ╬ ╬ ╬     ╬ ╬ ╬     ╬ ╬     ╬ ╬ ╬     ╬ ╬ ╬     ╬ ╬ ╬     ╬ ╬ ╬     ╬ ╬ ╬     ╬ ╬ ╬     ☼
☼     ╬ ╬ ╬     ╬ ╬ ╬     ╬ ╬ ╬     ╬ ╬ ╬     ╬ ╬ ╬     ╬ ╬ ╬     ╬ ╬     ╬ ╬ ╬     ╬ ╬ ╬     ╬ ╬ ╬ ╬ ╬ ╬     ╬ ╬ ╬     ╬ ╬ ╬     ╬ ╬     ╬ ╬ ╬     ╬ ╬ ╬     ╬ ╬ ╬     ╬ ╬ ╬     ╬ ╬ ╬     ╬ ╬ ╬     ☼
☼     ╬ ╬ ╬     ╬ ╬ ╬     ╬ ╬ ╬     ╬ ╬ ╬     ╬ ╬ ╬     ╬ ╬ ╬     ╬ ╬     ╬ ╬ ╬     ╬ ╬ ╬     ╬ ╬ ╬ ╬ ╬ ╬     ╬ ╬ ╬     ╬ ╬ ╬     ╬ ╬     ╬ ╬ ╬     ╬ ╬ ╬     ╬ ╬ ╬     ╬ ╬ ╬     ╬ ╬ ╬     ╬ ╬ ╬     ☼
☼     ╬ ╬ ╬     ╬ ╬ ╬     ╬ ╬ ╬     ╬ ╬ ╬     ╬ ╬ ╬     ╬ ╬ ╬     ╬ ╬     ╬ ╬ ╬     ╬ ╬ ╬     ╬ ╬ ╬ ╬ ╬ ╬     ╬ ╬ ╬     ╬ ╬ ╬     ╬ ╬     ╬ ╬ ╬     ╬ ╬ ╬     ╬ ╬ ╬     ╬ ╬ ╬     ╬ ╬ ╬     ╬ ╬ ╬     ☼
☼     ╬ ╬ ╬     ╬ ╬ ╬     ╬ ╬ ╬ ╬ ╬ ╬ ╬ ╬     ╬ ╬ ╬     ╬ ╬ ╬     ╬ ╬     ╬ ╬ ╬     ╬ ╬ ╬     ╬ ╬ ╬ ╬ ╬ ╬     ╬ ╬ ╬     ╬ ╬ ╬     ╬ ╬     ╬ ╬ ╬     ╬ ╬ ╬     ╬ ╬ ╬ ╬ ╬ ╬ ╬ ╬     ╬ ╬ ╬     ╬ ╬ ╬     ☼
☼     ╬ ╬ ╬     ╬ ╬ ╬     ╬ ╬ ╬ ╬ ╬ ╬ ╬ ╬     ╬ ╬ ╬     ╬ ╬ ╬     ╬ ╬     ╬ ╬ ╬     ╬ ╬ ╬     ╬ ╬ ╬ ╬ ╬ ╬     ╬ ╬ ╬     ╬ ╬ ╬     ╬ ╬     ╬ ╬ ╬     ╬ ╬ ╬     ╬ ╬ ╬ ╬ ╬ ╬ ╬ ╬     ╬ ╬ ╬     ╬ ╬ ╬     ☼
☼     ╬ ╬ ╬     ╬ ╬ ╬     ╬ ╬ ╬     ╬ ╬ ╬     ╬ ╬ ╬     ╬ ╬ ╬     ╬ ╬     ╬ ╬ ╬     ╬ ╬ ╬     ╬ ╬ ╬ ╬ ╬ ╬     ╬ ╬ ╬     ╬ ╬ ╬     ╬ ╬     ╬ ╬ ╬     ╬ ╬ ╬     ╬ ╬ ╬     ╬ ╬ ╬     ╬ ╬ ╬     ╬ ╬ ╬     ☼
☼     ╬ ╬ ╬     ╬ ╬ ╬     ╬ ╬ ╬     ╬ ╬ ╬     ╬ ╬ ╬     ╬ ╬ ╬     ╬ ╬     ╬ ╬ ╬     ╬ ╬ ╬     ╬ ╬ ╬ ╬ ╬ ╬     ╬ ╬ ╬     ╬ ╬ ╬     ╬ ╬     ╬ ╬ ╬     ╬ ╬ ╬     ╬ ╬ ╬     ╬ ╬ ╬     ╬ ╬ ╬     ╬ ╬ ╬     ☼
☼                                                                 ʘ ╬                                                             ╬ ʘ                                                                 ☼
☼                                                                 ╬ ╬                                                             ╬ ╬                                                                 ☼
☼ ☼ ☼       ╬ ╬ ╬ ╬ ╬                         ╬ ╬ ╬ ╬ ╬       ☼ ☼ ☼ ☼ ☼ ☼       ╬ ╬ ╬ ╬ ╬                     ╬ ╬ ╬ ╬ ╬       ☼ ☼ ☼ ☼ ☼ ☼       ╬ ╬ ╬ ╬ ╬                         ╬ ╬ ╬ ╬ ╬       ☼ ☼ ☼
☼           ╬ ╬ ╬ ╬ ╬               ╬ ╬ ╬     ╬ ╬ ╬ ╬ ╬           ╬ ╬           ╬ ╬ ╬ ╬ ╬     ╬ ╬ ╬ ╬ ╬ ╬     ╬ ╬ ╬ ╬ ╬           ╬ ╬           ╬ ╬ ╬ ╬ ╬     ╬ ╬ ╬               ╬ ╬ ╬ ╬ ╬           ☼
☼                                   ╬ ╬ ╬                                                     ╬ ╬ ╬ ╬ ╬ ╬                                                     ╬ ╬ ╬                                   ☼
☼               ╬ ╬ ╬               ╬ ╬ ╬                                                     ╬ ╬ ╬ ╬ ╬ ╬                                                     ╬ ╬ ╬               ╬ ╬ ╬               ☼
☼     ╬ ╬ ╬     ╬ ╬ ╬               ╬ ╬ ╬     ╬ ╬ ╬                 ‖     ╬ ╬ ╬     ╬ ╬ ╬                     ╬ ╬ ╬     ╬ ╬ ╬     ‖                 ╬ ╬ ╬     ╬ ╬ ╬               ╬ ╬ ╬     ╬ ╬ ╬     ☼
☼     ╬ ╬ ╬     ╬ ╬ ╬               ╬ ╬ ╬     ╬ ╬ ╬                 ‖                                                             ‖                 ╬ ╬ ╬     ╬ ╬ ╬               ╬ ╬ ╬     ╬ ╬ ╬     ☼
☼ ‖   ╬ ╬ ╬     ╬ ╬ ╬     ╬ ╬ ╬     ╬ ╬ ╬     ╬ ╬ ╬                 ‖                         ╬ ╬ ╬ ╬ ╬ ╬                         ‖                 ╬ ╬ ╬     ╬ ╬ ╬     ╬ ╬ ╬     ╬ ╬ ╬     ╬ ╬ ╬   ‖ ☼
☼ ‖   ╬ ╬ ╬     ╬ ╬ ╬     ╬ ╬ ╬     ╬ ╬ ╬     ╬ ╬ ╬                 ╬                         ╬ ╬ ╬ ╬ ╬ ╬                         ╬                 ╬ ╬ ╬     ╬ ╬ ╬     ╬ ╬ ╬     ╬ ╬ ╬     ╬ ╬ ╬   ‖ ☼
☼     ╬ ╬ ╬     ╬ ╬ ╬     ╬ ╬ ╬     ╬ ╬ ╬     ╬ ╬ ╬               ╬ ╬ ╬             ╬ ╬ ╬     ╬ ╬ ╬ ╬ ╬ ╬     ╬ ╬ ╬             ╬ ╬ ╬               ╬ ╬ ╬     ╬ ╬ ╬     ╬ ╬ ╬     ╬ ╬ ╬     ╬ ╬ ╬     ☼
☼     ╬ ╬ ╬     ╬ ╬ ╬     ╬ ╬ ╬     ╬ ╬ ╬     ╬ ╬ ╬             ╬ ╬ ╬ ╬ ╬                     ╬ ╬ ╬ ╬ ╬ ╬                     ╬ ╬ ╬ ╬ ╬             ╬ ╬ ╬     ╬ ╬ ╬     ╬ ╬ ╬     ╬ ╬ ╬     ╬ ╬ ╬     ☼
☼     ╬ ╬ ╬     ╬ ╬ ╬     ╬ ╬ ╬               ╬ ╬ ╬           ╬ ╬ ╬   ╬ ╬ ╬         ╬ ╬ ╬     ╬ ╬ ╬ ╬ ╬ ╬     ╬ ╬ ╬         ╬ ╬ ╬   ╬ ╬ ╬           ╬ ╬ ╬               ╬ ╬ ╬     ╬ ╬ ╬     ╬ ╬ ╬     ☼
☼     ╬ ╬ ╬               ╬ ╬ ╬               ╬ ╬ ╬         ╬ ╬ ╬       ╬ ╬ ╬                 ╬ ╬ ╬ ╬ ╬ ╬                 ╬ ╬ ╬       ╬ ╬ ╬         ╬ ╬ ╬               ╬ ╬ ╬               ╬ ╬ ╬     ☼
☼     ʘ                   ╬ ╬ ╬               ╬ ╬ ╬     ʘ ╬ ╬ ╬           ╬ ╬ ╬ ʘ             ╬ ╬ ╬ ╬ ╬ ╬             ʘ ╬ ╬ ╬           ╬ ╬ ╬ ʘ     ╬ ╬ ╬               ╬ ╬ ╬                   ʘ     ☼
☼     ╬ ╬ ╬               ╬ ╬ ╬               ╬ ╬ ╬     ╬ ╬ ╬               ╬ ╬ ╬   ╬ ╬ ╬     ╬ ╬ ╬ ╬ ╬ ╬     ╬ ╬ ╬   ╬ ╬ ╬               ╬ ╬ ╬     ╬ ╬ ╬               ╬ ╬ ╬               ╬ ╬ ╬     ☼
☼                                                                                                                                                                                                     ☼
☼                           ʘ         ʘ                                                         ʘ     ʘ                                                         ʘ         ʘ                           ☼
☼ ☼ ☼ ☼ ☼ ☼ ☼ ☼ ʘ ☼ ☼ ☼ ☼ ☼ ☼ ☼ ☼ ☼ ☼ ☼ ☼ ☼ ☼ ☼ ☼ ☼ ☼ ☼ ☼ ☼ ☼ ☼ ☼ ☼ ☼ ☼ ☼ ☼ ☼ ☼ ☼ ☼ ʘ ☼ ☼ ☼ ☼ ☼ ☼ ☼ ☼ ☼ ☼ ☼ ☼ ☼ ☼ ☼ ☼ ☼ ☼ ☼ ☼ ☼ ☼ ☼ ☼ ☼ ☼ ☼ ☼ ☼ ☼ ☼ ☼ ☼ ☼ ☼ ☼ ☼ ☼ ☼ ☼ ☼ ☼ ☼ ☼ ☼ ☼ ☼ ☼ ☼ ☼ ☼ ☼ ☼ ☼ ☼ ☼ ☼
