☼ ☼ ☼ ☼ ☼ ☼ ☼ ☼ ☼ ☼ ☼ ☼ ☼ ☼ ☼ ☼ ☼ ☼ ☼ ☼ ☼ ☼ ☼ ☼ ☼ ☼ ☼ ☼ ☼ ☼ ☼ ☼ ☼ ☼ ☼ ☼ ☼ ☼ ☼ ☼ ☼ ☼ ☼ ☼ ☼ ☼ ☼ ☼ ☼ ☼ ☼ ☼ ☼ ☼ ☼ ☼ ☼ ☼ ☼ ☼ ☼ ☼ ☼ ☼ ☼ ☼ ☼ ☼ ☼ ☼ ☼ ☼ ☼ ☼ ☼ ☼ ☼ ☼ ☼ ☼ ☼ ☼ ☼ ☼ ☼ ☼ ☼ ☼ ☼ ☼ ☼ ☼ ☼ ☼ ☼ ☼ ☼ ☼ ☼ ☼ ☼ ☼
☼   ¿         ¿         ¿                 ¿         ¿             ☼ ☼             ¿         ¿                 ¿                       ☼ ☼             ¿         ¿                 ¿         ¿         ¿   ☼
☼                                                                                                                                                                                                         ☼
☼     ╬ ╬ ╬                                                                                   ╬             ╬                                                                                   ╬ ╬ ╬     ☼
☼     ╬ ╬ ╬               ╬ ╬ ╬     ╬ ╬ ╬                                                     ╬ ╬         ╬ ╬                                                     ╬ ╬ ╬     ╬ ╬ ╬               ╬ ╬ ╬     ☼
☼     ╬ ╬ ╬               ╬ ╬ ╬     ╬ ╬ ╬               ╬ ╬ ╬             ╬ ╬ ╬               ╬ ╬ ╬     ╬ ╬ ╬               ╬ ╬ ╬             ╬ ╬ ╬               ╬ ╬ ╬     ╬ ╬ ╬               ╬ ╬ ╬     ☼
☼     ╬ ╬ ╬               ╬ ╬ ╬ ☼ ☼ ╬ ╬ ╬               ╬ ╬ ╬             ╬ ╬ ╬               ╬ ╬ ╬ ☼ ☼ ╬ ╬ ╬               ╬ ╬ ╬             ╬ ╬ ╬               ╬ ╬ ╬ ☼ ☼ ╬ ╬ ╬               ╬ ╬ ╬     ☼
☼     ╬ ╬ ╬               ╬ ╬ ╬ ☼ ☼ ╬ ╬ ╬               ╬ ╬ ╬             ╬ ╬ ╬               ╬ ╬ ╬ ☼ ☼ ╬ ╬ ╬               ╬ ╬ ╬             ╬ ╬ ╬               ╬ ╬ ╬ ☼ ☼ ╬ ╬ ╬               ╬ ╬ ╬     ☼
☼     ╬ ╬ ╬               ╬ ╬ ╬ ☼ ☼ ╬ ╬ ╬               ╬ ╬ ╬             ╬ ╬ ╬               ╬ ╬ ╬ ☼ ☼ ╬ ╬ ╬               ╬ ╬ ╬             ╬ ╬ ╬               ╬ ╬ ╬ ☼ ☼ ╬ ╬ ╬               ╬ ╬ ╬     ☼
☼     ╬ ╬ ╬               ╬ ╬ ╬     ╬ ╬ ╬               ╬ ╬ ╬             ╬ ╬ ╬               ╬ ╬ ╬     ╬ ╬ ╬               ╬ ╬ ╬             ╬ ╬ ╬               ╬ ╬ ╬     ╬ ╬ ╬               ╬ ╬ ╬     ☼
☼     ╬ ╬ ╬                                             ╬ ╬ ╬             ╬ ╬ ╬               ╬ ╬         ╬ ╬               ╬ ╬ ╬             ╬ ╬ ╬                                             ╬ ╬ ╬     ☼
☼     ╬ ╬ ╬                                               ╬ ╬ ╬         ╬ ╬ ╬                                                 ╬ ╬ ╬         ╬ ╬ ╬                                               ╬ ╬ ╬     ☼
☼     ╬ ╬ ╬                                               ╬ ╬ ╬         ╬ ╬ ╬                                                 ╬ ╬ ╬         ╬ ╬ ╬                                               ╬ ╬ ╬     ☼
☼                                                                                             ╬ ╬ ╬     ╬ ╬ ╬                                                                                             ☼
☼                                                                                             ╬ ╬ ╬     ╬ ╬ ╬                                                     ╬ ╬ ╬     ╬ ╬ ╬                         ☼
☼           ╬ ╬ ╬ ╬                           ╬ ╬ ╬ ╬             ☼ ☼                                                                 ☼ ☼                         ╬ ╬ ╬     ╬ ╬ ╬                         ☼
☼ ☼ ☼       ╬ ╬ ╬ ╬                           ╬ ╬ ╬ ╬           ☼ ☼ ☼ ☼                                                             ☼ ☼ ☼ ☼                                                           ☼ ☼ ☼
☼                                                                 ☼ ☼                                                                 ☼ ☼                                                                 ☼
☼                         ☼ ☼ ☼ ☼ ☼ ☼                                         ☼ ☼ ☼ ☼ ☼ ☼                       ☼ ☼ ☼ ☼ ☼ ☼                             ☼ ☼ ☼ ☼ ☼ ☼       ☼ ☼ ☼ ☼ ☼ ☼                     ☼
☼                         ☼ ☼ ☼ ☼ ☼ ☼                                         ☼ ☼ ☼ ╬ ☼ ☼ ☼                   ☼ ☼ ☼ ╬ ╬ ☼ ☼ ☼                           ☼ ☼ ☼ ☼ ☼ ☼       ☼ ☼ ☼ ☼ ☼ ☼                     ☼
☼             ☼ ☼ ☼       ☼ ☼ ☼               ╬ ╬ ╬                           ☼ ☼ ☼ ╬ ╬ ☼ ☼ ☼                 ☼ ☼ ☼ ╬ ╬ ☼ ☼ ☼                           ☼ ☼ ☼   ☼ ☼ ☼   ☼ ☼ ☼   ☼ ☼ ☼     ☼ ☼ ☼           ☼
☼           ☼ ╬ ☼         ☼ ☼ ☼               ╬ ╬ ╬         ╬ ╬ ╬ ╬ ╬         ☼ ☼ ☼ ╬ ╬ ☼ ☼ ☼                 ☼ ☼ ☼ ╬ ╬ ☼ ☼ ☼          ╬                ☼ ☼ ☼     ☼ ☼ ☼ ☼ ☼     ☼ ☼ ☼       ☼ ╬ ☼         ☼
☼         ☼ ╬ ☼           ☼ ☼ ☼ ☼ ☼ ☼         ╬ ╬ ╬         ╬ ╬ ¿ ╬ ╬         ☼ ☼ ☼ ╬ ☼ ☼ ☼                   ☼ ☼ ☼ ☼ ☼ ☼ ☼ ☼        ╬ ╬ ╬              ☼ ☼ ☼     ☼ ☼ ☼ ☼ ☼     ☼ ☼ ☼         ☼ ╬ ☼       ☼
☼       ☼ ╬ ☼             ☼ ☼ ☼ ☼ ☼ ☼         ╬ ╬ ╬         ╬ ╬ ╬ ╬ ╬         ☼ ☼ ☼ ☼ ☼ ☼                     ☼ ☼ ☼ ☼ ☼ ☼ ☼ ☼      ╬ ╬ ╬ ╬ ╬            ☼ ☼ ☼       ☼ ☼ ☼       ☼ ☼ ☼           ☼ ╬ ☼     ☼
☼         ☼ ╬ ☼           ☼ ☼ ☼               ╬ ╬ ╬         ╬ ╬ ╬ ╬ ╬         ☼ ☼ ☼                           ☼ ☼ ☼     ☼ ☼ ☼        ╬ ╬ ╬              ☼ ☼ ☼         ☼         ☼ ☼ ☼         ☼ ╬ ☼       ☼
☼           ☼ ╬ ☼         ☼ ☼ ☼               ╬ ╬ ╬                           ☼ ☼ ☼                           ☼ ☼ ☼     ☼ ☼ ☼          ╬                ☼ ☼ ☼                   ☼ ☼ ☼       ☼ ╬ ☼         ☼
☼             ☼ ☼ ☼       ☼ ☼ ☼ ☼ ☼ ☼                                         ☼ ☼ ☼                           ☼ ☼ ☼     ☼ ☼ ☼                           ☼ ☼ ☼                   ☼ ☼ ☼     ☼ ☼ ☼           ☼
☼                         ☼ ☼ ☼ ☼ ☼ ☼                                         ☼ ☼ ☼                           ☼ ☼ ☼     ☼ ☼ ☼                           ☼ ☼ ☼                   ☼ ☼ ☼                     ☼
☼                                                                                                                                                                                                         ☼
☼                                                                                                                                                                                                         ☼
☼                                                                 ☼ ☼                                                                 ☼ ☼                                                                 ☼
☼                                                               ☼ ☼ ☼ ☼                                                             ☼ ☼ ☼ ☼                                                               ☼
☼                                                           ☼ ☼ ☼ ☼ ☼ ☼ ☼ ☼                                                     ☼ ☼ ☼ ☼ ☼ ☼ ☼ ☼                                                           ☼
☼                                                           ☼ ☼ ☼ ☼ ☼ ☼ ☼ ☼                                                     ☼ ☼ ☼ ☼ ☼ ☼ ☼ ☼                                                           ☼
☼                                                               ☼ ☼ ☼ ☼                                                             ☼ ☼ ☼ ☼                                                               ☼
☼   ¿         ¿         ¿                 ¿         ¿             ☼ ☼             ¿         ¿                 ¿           ¿           ☼ ☼             ¿         ¿                 ¿         ¿         ¿   ☼
☼                                                                                           ╬ ╬             ╬ ╬                               ╬ ╬ ╬                                             ╬ ╬ ╬     ☼
☼                         ╬ ╬ ╬     ╬ ╬ ╬                                                 ╬ ╬ ╬ ╬         ╬ ╬ ╬ ╬                             ╬ ╬ ╬                                             ╬ ╬ ╬     ☼
☼                         ╬ ╬ ╬     ╬ ╬ ╬                                                 ╬ ╬ ╬ ╬ ╬     ╬ ╬ ╬ ╬ ╬                             ╬ ╬ ╬                                             ╬ ╬ ╬     ☼
☼                         ╬ ╬ ╬     ╬ ╬ ╬                                                                                                     ╬ ╬ ╬                                             ╬ ╬ ╬     ☼
☼           ╬ ╬ ╬         ╬ ╬ ╬ ☼ ☼ ╬ ╬ ╬             ╬ ╬ ╬               ╬ ╬ ╬                                             ╬ ╬ ╬             ╬ ╬ ╬                                             ╬ ╬ ╬     ☼
☼           ╬ ╬ ╬         ╬ ╬ ╬ ☼ ☼ ╬ ╬ ╬             ╬ ╬ ╬             ╬ ╬ ╬                 ╬ ╬ ╬ ☼ ☼ ╬ ╬ ╬                 ╬ ╬ ╬           ╬ ╬ ╬                                             ╬ ╬ ╬     ☼
☼           ╬ ╬ ╬         ╬ ╬ ╬ ☼ ☼ ╬ ╬ ╬             ╬ ╬ ╬             ╬ ╬ ╬                 ╬ ╬ ╬ ☼ ☼ ╬ ╬ ╬                 ╬ ╬ ╬           ╬ ╬ ╬               ╬ ╬ ╬ ╬ ╬ ╬ ╬ ╬               ╬ ╬ ╬     ☼
☼           ╬ ╬ ╬         ╬ ╬ ╬     ╬ ╬ ╬             ╬ ╬ ╬           ╬ ╬ ╬         ╬ ╬ ╬     ╬ ╬ ╬     ╬ ╬ ╬                   ╬ ╬ ╬         ╬ ╬ ╬               ╬ ╬ ╬ ╬ ╬ ╬ ╬ ╬               ╬ ╬ ╬     ☼
☼           ╬ ╬ ╬         ╬ ╬ ╬     ╬ ╬ ╬             ╬ ╬ ╬         ╬ ╬ ╬           ╬ ╬ ╬     ╬ ╬ ╬     ╬ ╬ ╬     ╬ ╬ ╬           ╬ ╬ ╬       ╬ ╬ ╬                                             ╬ ╬ ╬     ☼
☼           ╬ ╬ ╬                                     ╬ ╬ ╬         ╬ ╬ ╬           ╬ ╬ ╬ ╬ ╬ ╬ ╬ ╬     ╬ ╬ ╬ ╬ ╬ ╬ ╬ ╬           ╬ ╬ ╬                                                                   ☼
☼                                                                                   ╬ ╬ ╬ ╬ ╬                 ╬ ╬ ╬ ╬ ╬                                                                                   ☼
☼                         ╬ ╬ ╬     ╬ ╬ ╬                                           ╬                                 ╬                                                                                   ☼
☼                         ╬ ╬ ╬     ╬ ╬ ╬                                                                                                                                                                 ☼
☼               ╬ ╬ ╬ ╬ ╬ ╬ ╬ ╬     ╬ ╬ ╬ ╬ ╬ ╬ ╬ ╬               ☼ ☼                                                                 ☼ ☼             ╬ ╬ ╬ ╬ ╬ ╬ ╬ ╬ ╬     ╬ ╬ ╬ ╬ ╬ ╬ ╬ ╬ ╬             ☼
☼ ☼ ☼           ╬ ╬ ╬ ╬ ╬ ╬ ╬ ╬     ╬ ╬ ╬ ╬ ╬ ╬ ╬ ╬             ☼ ☼ ☼ ☼                                                             ☼ ☼ ☼ ☼           ╬ ╬ ╬ ╬ ╬ ╬ ╬ ╬ ╬     ╬ ╬ ╬ ╬ ╬ ╬ ╬ ╬ ╬         ☼ ☼ ☼
☼                                                                 ☼ ☼           ╬ ╬ ╬                                 ╬ ╬ ╬           ☼ ☼                         ╬ ╬ ╬     ╬ ╬ ╬                         ☼
☼                                                                             ╬ ╬ ╬ ╬                                 ╬ ╬ ╬ ╬                                     ╬ ╬ ╬     ╬ ╬ ╬                         ☼
☼                                                                         ╬ ╬ ╬     ╬ ╬ ╬                         ╬ ╬ ╬     ╬ ╬ ╬                                                                         ☼
☼     ╬ ╬ ╬                                             ╬ ╬ ╬             ╬ ╬ ╬     ╬ ╬ ╬ ╬ ╬ ╬ ╬         ╬ ╬ ╬ ╬ ╬ ╬ ╬     ╬ ╬ ╬               ╬ ╬ ╬                                     ╬ ╬ ╬           ☼
☼     ╬ ╬ ╬               ╬ ╬ ╬ ╬ ╬ ╬ ╬ ╬               ╬ ╬ ╬                       ╬ ╬ ╬ ╬ ╬ ╬ ╬         ╬ ╬ ╬ ╬ ╬ ╬ ╬                         ╬ ╬ ╬                                     ╬ ╬ ╬           ☼
☼     ╬ ╬ ╬               ╬ ╬ ╬ ╬ ╬ ╬ ╬ ╬               ╬ ╬ ╬                       ╬ ╬ ╬     ╬ ╬         ╬ ╬     ╬ ╬ ╬                         ╬ ╬ ╬             ╬ ╬ ╬     ╬ ╬ ╬         ╬ ╬ ╬           ☼
☼     ╬ ╬ ╬                                             ╬ ╬ ╬                       ╬ ╬ ╬     ╬ ╬         ╬ ╬     ╬ ╬ ╬                         ╬ ╬ ╬             ╬ ╬ ╬     ╬ ╬ ╬         ╬ ╬ ╬           ☼
☼     ╬ ╬ ╬                                             ╬ ╬ ╬                                                                                   ╬ ╬ ╬             ╬ ╬ ╬ ☼ ☼ ╬ ╬ ╬         ╬ ╬ ╬           ☼
☼     ╬ ╬ ╬                                             ╬ ╬ ╬                                                                                   ╬ ╬ ╬             ╬ ╬ ╬ ☼ ☼ ╬ ╬ ╬         ╬ ╬ ╬           ☼
☼     ╬ ╬ ╬                                             ╬ ╬ ╬             ╬ ╬ ╬                                             ╬ ╬ ╬                                 ╬ ╬ ╬ ☼ ☼ ╬ ╬ ╬                         ☼
☼     ╬ ╬ ╬                                             ╬ ╬ ╬             ╬ ╬ ╬                                             ╬ ╬ ╬                                 ╬ ╬ ╬     ╬ ╬ ╬                         ☼
☼     ╬ ╬ ╬                                             ╬ ╬ ╬             ╬ ╬ ╬                                             ╬ ╬ ╬                                 ╬ ╬ ╬     ╬ ╬ ╬                         ☼
☼                                                                         ╬ ╬ ╬                                             ╬ ╬ ╬                                 ╬ ╬ ╬     ╬ ╬ ╬                         ☼
☼                                                                         ╬ ╬ ╬                                             ╬ ╬ ╬                                                                         ☼
☼                                                                                                                                                                                                         ☼
☼                                                                 ☼ ☼                                                                 ☼ ☼                                                                 ☼
☼                                                               ☼ ☼ ☼ ☼                                                             ☼ ☼ ☼ ☼                                                               ☼
☼             ¿         ¿                 ¿         ¿             ☼ ☼                                         ¿         ¿             ☼ ☼             ¿         ¿                 ¿           ¿           ☼
☼                                                                                                                                                                                                         ☼
☼               ☼ ☼ ☼ ☼                     ☼ ☼ ☼ ☼                         ╬ ╬ ╬ ╬ ╬ ╬ ╬ ╬ ╬ ╬ ╬         ╬ ╬ ╬ ╬ ╬ ╬ ╬ ╬ ╬ ╬ ╬                         ╬ ╬ ╬     ╬ ╬ ╬     ╬ ╬ ╬     ╬ ╬ ╬               ☼
☼                   ☼ ☼                     ☼ ☼                           ╬ ╬ ╬ ╬ ╬ ╬ ╬ ╬ ╬ ╬ ╬ ╬ ╬     ╬ ╬ ╬ ╬ ╬ ╬ ╬ ╬ ╬ ╬ ╬ ╬ ╬                       ╬ ╬ ╬     ╬ ╬ ╬     ╬ ╬ ╬     ╬ ╬ ╬               ☼
☼     ☼ ☼           ☼ ☼                     ☼ ☼           ☼ ☼             ╬ ╬ ╬               ╬ ╬ ╬     ╬ ╬ ╬               ╬ ╬ ╬                       ╬ ╬ ╬     ╬ ╬ ╬     ╬ ╬ ╬     ╬ ╬ ╬               ☼
☼     ☼ ☼ ☼ ☼                                         ☼ ☼ ☼ ☼             ╬ ╬ ╬               ╬ ╬ ╬ ☼ ☼ ╬ ╬ ╬               ╬ ╬ ╬             ╬ ╬ ╬     ╬ ╬ ╬     ╬ ╬ ╬ ☼ ☼ ╬ ╬ ╬     ╬ ╬ ╬     ╬ ╬ ╬     ☼
☼                         ╬ ╬ ╬ ☼ ☼ ╬ ╬ ╬                                 ╬ ╬ ╬               ╬ ╬ ╬ ☼ ☼ ╬ ╬ ╬               ╬ ╬ ╬             ╬ ╬ ╬     ╬ ╬ ╬     ╬ ╬ ╬ ☼ ☼ ╬ ╬ ╬     ╬ ╬ ╬     ╬ ╬ ╬     ☼
☼                         ╬ ╬ ╬ ☼ ☼ ╬ ╬ ╬                                 ╬ ╬ ╬               ╬ ╬ ╬ ☼ ☼ ╬ ╬ ╬               ╬ ╬ ╬             ╬ ╬ ╬     ╬ ╬ ╬     ╬ ╬ ╬ ☼ ☼ ╬ ╬ ╬     ╬ ╬ ╬     ╬ ╬ ╬     ☼
☼                         ╬ ╬ ╬     ╬ ╬ ╬                                 ╬ ╬ ╬               ╬ ╬ ╬     ╬ ╬ ╬               ╬ ╬ ╬             ╬ ╬ ╬     ╬ ╬ ╬     ╬ ╬ ╬     ╬ ╬ ╬     ╬ ╬ ╬     ╬ ╬ ╬     ☼
☼     ╬ ╬ ╬               ╬ ╬ ╬     ╬ ╬ ╬               ╬ ╬ ╬             ╬ ╬ ╬               ╬ ╬ ╬     ╬ ╬ ╬               ╬ ╬ ╬             ╬ ╬ ╬               ╬ ╬ ╬     ╬ ╬ ╬               ╬ ╬ ╬     ☼
☼     ╬ ╬ ╬                                             ╬ ╬ ╬             ╬ ╬ ╬                                             ╬ ╬ ╬             ╬ ╬ ╬                                             ╬ ╬ ╬     ☼
☼     ╬ ╬ ╬                                             ╬ ╬ ╬                                                                                 ╬ ╬ ╬                                             ╬ ╬ ╬     ☼
☼                         ╬ ╬ ╬     ╬ ╬ ╬                                                                                                                                                                 ☼
☼                         ╬ ╬ ╬ ☼ ☼ ╬ ╬ ╬                                                                                                                                                                 ☼
☼                 ☼ ☼     ╬ ╬ ╬ ☼ ☼ ╬ ╬ ╬     ☼ ☼                 ☼ ☼           ╬ ╬                                     ╬ ╬           ☼ ☼           ╬ ╬ ╬ ╬ ╬                         ╬ ╬ ╬ ╬ ╬           ☼
☼ ☼ ☼             ☼ ☼     ╬ ╬ ╬     ╬ ╬ ╬     ☼ ☼               ☼ ☼ ☼ ☼         ╬ ╬                                     ╬ ╬         ☼ ☼ ☼ ☼         ╬ ╬ ╬ ╬ ╬                         ╬ ╬ ╬ ╬ ╬       ☼ ☼ ☼
☼                                                                 ☼ ☼           ╬ ╬ ╬                                 ╬ ╬ ╬           ☼ ☼                                                                 ☼
☼                                                                               ╬ ╬ ╬               ╬ ╬               ╬ ╬ ╬                                       ╬ ╬ ╬     ╬ ╬ ╬                         ☼
☼                         ╬ ╬ ╬     ╬ ╬ ╬                                 ╬         ╬ ╬         ╬ ╬ ╬ ╬ ╬ ╬         ╬ ╬         ╬             ╬ ╬ ╬               ╬ ╬ ╬     ╬ ╬ ╬               ╬ ╬ ╬     ☼
☼                         ╬ ╬ ╬ ☼ ☼ ╬ ╬ ╬                                 ╬ ╬       ╬ ╬         ╬ ╬ ╬ ╬ ╬ ╬         ╬ ╬       ╬ ╬             ╬ ╬ ╬               ╬ ╬ ╬     ╬ ╬ ╬               ╬ ╬ ╬     ☼
☼     ╬ ╬ ╬               ╬ ╬ ╬ ☼ ☼ ╬ ╬ ╬               ╬ ╬ ╬             ╬ ╬ ╬                 ╬ ╬ ╬ ╬ ╬ ╬                 ╬ ╬ ╬             ╬ ╬ ╬               ╬ ╬ ╬ ╬ ╬ ╬ ╬ ╬               ╬ ╬ ╬     ☼
☼     ╬ ╬ ╬                                             ╬ ╬ ╬             ╬ ╬ ╬                     ╬ ╬                     ╬ ╬ ╬             ╬ ╬ ╬               ╬ ╬ ╬ ╬ ╬ ╬ ╬ ╬               ╬ ╬ ╬     ☼
☼     ╬ ╬ ╬     ☼ ☼                             ☼ ☼     ╬ ╬ ╬ ╬ ╬ ╬ ╬ ╬ ╬ ╬ ╬ ╬                                             ╬ ╬ ╬ ╬ ╬ ╬ ╬ ╬ ╬ ╬ ╬ ╬               ╬ ╬ ╬     ╬ ╬ ╬               ╬ ╬ ╬     ☼
☼     ╬ ╬ ╬     ☼ ☼       ╬ ╬ ╬     ╬ ╬ ╬       ☼ ☼     ╬ ╬ ╬ ╬ ╬ ╬ ╬ ╬ ╬ ╬ ╬ ╬                                             ╬ ╬ ╬ ╬ ╬ ╬ ╬ ╬ ╬ ╬ ╬ ╬               ╬ ╬ ╬     ╬ ╬ ╬               ╬ ╬ ╬     ☼
☼     ╬ ╬ ╬               ╬ ╬ ╬ ☼ ☼ ╬ ╬ ╬               ╬ ╬ ╬                                     ╬ ╬ ╬ ╬                                     ╬ ╬ ╬               ╬ ╬ ╬     ╬ ╬ ╬               ╬ ╬ ╬     ☼
☼     ╬ ╬ ╬               ╬ ╬ ╬ ☼ ☼ ╬ ╬ ╬               ╬ ╬ ╬                                     ╬ ╬ ╬ ╬                                     ╬ ╬ ╬               ╬ ╬ ╬     ╬ ╬ ╬               ╬ ╬ ╬     ☼
☼     ╬ ╬ ╬               ╬ ╬ ╬     ╬ ╬ ╬               ╬ ╬ ╬                                                                                 ╬ ╬ ╬                                             ╬ ╬ ╬     ☼
☼     ╬ ╬ ╬                                             ╬ ╬ ╬                     ╬ ╬ ╬                             ╬ ╬ ╬                     ╬ ╬ ╬                                             ╬ ╬ ╬     ☼
☼                                                                         ╬ ╬ ╬ ╬ ╬ ╬                                 ╬ ╬ ╬ ╬ ╬ ╬             ╬ ╬ ╬                                             ╬ ╬ ╬     ☼
☼                                                                         ╬ ╬ ╬ ╬ ╬ ╬             ╬ ╬ ╬ ╬             ╬ ╬ ╬ ╬ ╬ ╬             ╬ ╬ ╬                                             ╬ ╬ ╬     ☼
☼                               ☼ ☼                                                               ╬ ╬ ╬ ╬                                                                                                 ☼
☼                                                                                                                                                                                                         ☼
☼                                                               ☼ ☼ ☼ ☼                                                             ☼ ☼ ☼ ☼                                                               ☼
☼ ☼ ☼ ☼ ☼ ☼ ☼ ☼ ☼ ☼ ☼ ☼ ☼ ☼ ☼ ☼ ☼ ☼ ☼ ☼ ☼ ☼ ☼ ☼ ☼ ☼ ☼ ☼ ☼ ☼ ☼ ☼ ☼ ☼ ☼ ☼ ☼ ☼ ☼ ☼ ☼ ☼ ☼ ☼ ☼ ☼ ☼ ☼ ☼ ☼ ☼ ☼ ☼ ☼ ☼ ☼ ☼ ☼ ☼ ☼ ☼ ☼ ☼ ☼ ☼ ☼ ☼ ☼ ☼ ☼ ☼ ☼ ☼ ☼ ☼ ☼ ☼ ☼ ☼ ☼ ☼ ☼ ☼ ☼ ☼ ☼ ☼ ☼ ☼ ☼ ☼ ☼ ☼ ☼ ☼ ☼ ☼ ☼ ☼ ☼ ☼ ☼
