☼ ☼ ☼ ☼ ☼ ☼ ☼ ʘ ☼ ☼ ☼ ☼ ☼ ☼ ☼ ☼ ☼ ☼ ☼ ☼ ☼ ☼ ☼ ☼ ☼ ☼ ☼ ☼ ☼ ☼ ☼ ☼ ʘ ☼ ☼ ☼ ☼ ☼ ☼ ☼ ☼ ☼ ☼ ☼ ☼ ☼ ☼ ☼ ☼ ☼ ☼ ☼ ☼ ☼ ☼ ☼ ☼
☼                                                                                                               ☼
☼                                                                                                               ☼
☼   ☼ ☼ ☼               ☼ ☼ ☼                         ☼ ☼ ☼                         ☼ ☼ ☼               ☼ ☼ ☼   ☼
☼   ☼ ☼ ☼               ☼ ☼ ☼                         ☼ ☼ ☼                         ☼ ☼ ☼               ☼ ☼ ☼   ☼
☼   ☼ ☼ ☼               ☼ ☼ ☼                         ☼ ☼ ☼                         ☼ ☼ ☼               ☼ ☼ ☼   ☼
☼                                                                                                               ☼
☼                                                                                                               ☼
☼                                                                                                               ☼
☼   ☼ ☼ ☼               ☼ ☼ ☼                         ☼ ☼ ☼                         ☼ ☼ ☼               ☼ ☼ ☼   ☼
☼   ☼ ☼ ☼               ☼ ☼ ☼                         ☼ ☼ ☼                         ☼ ☼ ☼               ☼ ☼ ☼   ☼
☼   ☼ ☼ ☼               ☼ ☼ ☼                         ☼ ☼ ☼                         ☼ ☼ ☼               ☼ ☼ ☼   ☼
☼                                                                                                               ☼
☼                                                                                                               ☼
☼                                                                                                               ☼
☼             ☼ ☼ ☼               ☼ ☼ ☼                ╬ ╬                ☼ ☼ ☼               ☼ ☼ ☼             ☼
☼             ☼ ☼ ☼               ☼ ☼ ☼               ╬ ╬ ╬               ☼ ☼ ☼               ☼ ☼ ☼             ☼
☼             ☼ ☼ ☼               ☼ ☼ ☼               ╬ ╬ ╬               ☼ ☼ ☼               ☼ ☼ ☼             ☼
☼                                      ☼ ☼ ☼        ╬ ╬ ╬ ╬ ╬       ☼ ☼ ☼                                       ☼
☼                                      ☼ ☼ ☼    ╬ ╬ ╬ ╬ ╬ ╬ ╬ ╬ ╬   ☼ ☼ ☼                                       ☼
☼                                      ☼ ☼ ☼    ╬ ╬ ╬ ╬ ╬ ╬ ╬ ╬ ╬   ☼ ☼ ☼                                       ☼
☼   ╬ ╬ ╬               ☼ ☼ ☼               ╬ ╬ ╬ ╬ ╬ ╬ ╬ ╬ ╬ ╬ ╬ ╬ ╬               ☼ ☼ ☼               ╬ ╬ ╬   ☼
☼   ╬ ╬ ╬               ☼ ☼ ☼               ╬ ╬ ╬ ╬ ╬ ╬ ╬ ╬ ╬ ╬ ╬ ╬ ╬               ☼ ☼ ☼               ╬ ╬ ╬   ☼
☼   ╬ ╬ ╬               ☼ ☼ ☼               ╬ ╬ ╬ ╬ ╬ ╬ ╬ ╬ ╬ ╬ ╬ ╬ ╬               ☼ ☼ ☼               ╬ ╬ ╬   ☼
☼                             ☼ ☼ ☼           ╬ ╬ ╬ ╬ ╬ ╬ ╬ ╬ ╬ ╬ ╬           ☼ ☼ ☼                             ☼
☼                             ☼ ☼ ☼             ╬ ╬ ╬ ╬ ╬ ╬ ╬ ╬ ╬             ☼ ☼ ☼                             ☼
☼                             ☼ ☼ ☼               ╬ ╬ ╬ ╬ ╬ ╬ ╬               ☼ ☼ ☼                             ☼
☼   ╬ ╬ ╬      ╬ ╬ ╬                  ☼ ☼ ☼ ╬ ╬ ╬ ╬ ╬ ╬ ╬ ╬ ╬ ╬ ╬ ╬ ╬ ☼ ☼ ☼                   ╬ ╬ ╬     ╬ ╬ ╬   ☼
☼   ╬ ╬ ╬      ╬ ╬ ╬                  ☼ ☼ ☼ ╬ ╬ ╬ ╬ ╬ ╬ ╬ ╬ ╬ ╬ ╬ ╬ ╬ ☼ ☼ ☼                   ╬ ╬ ╬     ╬ ╬ ╬   ☼
☼   ╬ ╬ ╬      ╬ ╬ ╬                  ☼ ☼ ☼ ╬ ╬ ╬ ╬ ╬ ╬ ╬ ╬ ╬ ╬ ╬ ╬ ╬ ☼ ☼ ☼                   ╬ ╬ ╬     ╬ ╬ ╬   ☼
☼                             ☼ ☼ ☼               ╬ ╬ ╬ ╬ ╬ ╬ ╬               ☼ ☼ ☼                             ☼
☼                             ☼ ☼ ☼             ╬ ╬ ╬ ╬ ╬ ╬ ╬ ╬ ╬             ☼ ☼ ☼                             ☼
☼                             ☼ ☼ ☼           ╬ ╬ ╬ ╬ ╬ ╬ ╬ ╬ ╬ ╬ ╬           ☼ ☼ ☼                             ☼
☼   ╬ ╬ ╬               ☼ ☼ ☼               ╬ ╬ ╬ ╬ ╬ ╬ ╬ ╬ ╬ ╬ ╬ ╬ ╬               ☼ ☼ ☼               ╬ ╬ ╬   ☼
☼   ╬ ╬ ╬               ☼ ☼ ☼               ╬ ╬ ╬ ╬ ╬ ╬ ╬ ╬ ╬ ╬ ╬ ╬ ╬               ☼ ☼ ☼               ╬ ╬ ╬   ☼
☼   ╬ ╬ ╬               ☼ ☼ ☼               ╬ ╬ ╬ ╬ ╬ ╬ ╬ ╬ ╬ ╬ ╬ ╬ ╬               ☼ ☼ ☼               ╬ ╬ ╬   ☼
☼                                      ☼ ☼ ☼  ╬ ╬ ╬ ╬ ╬ ╬ ╬ ╬ ╬ ╬ ╬ ☼ ☼ ☼                                       ☼
☼                                      ☼ ☼ ☼  ╬ ╬ ╬ ╬ ╬ ╬ ╬ ╬ ╬ ╬ ╬ ☼ ☼ ☼                                       ☼
☼                                      ☼ ☼ ☼    ╬ ╬ ╬ ╬ ╬ ╬ ╬ ╬ ╬   ☼ ☼ ☼                                       ☼
☼             ☼ ☼ ☼               ☼ ☼ ☼           ╬ ╬ ╬ ╬ ╬ ╬ ╬           ☼ ☼ ☼               ☼ ☼ ☼             ☼
☼             ☼ ☼ ☼               ☼ ☼ ☼             ╬ ╬ ╬ ╬ ╬             ☼ ☼ ☼               ☼ ☼ ☼             ☼
☼             ☼ ☼ ☼               ☼ ☼ ☼               ╬ ╬ ╬               ☼ ☼ ☼               ☼ ☼ ☼             ☼
☼                                                                                                               ☼
☼                                                                                                               ☼
☼                                                                                                               ☼
☼   ☼ ☼ ☼               ☼ ☼ ☼                                                       ☼ ☼ ☼               ☼ ☼ ☼   ☼
☼   ☼ ☼ ☼               ☼ ☼ ☼                                                       ☼ ☼ ☼               ☼ ☼ ☼   ☼
☼   ☼ ☼ ☼               ☼ ☼ ☼                                                       ☼ ☼ ☼               ☼ ☼ ☼   ☼
☼                                                                                                               ☼
☼                                                                                                               ☼
☼                                                                                                               ☼
☼   ☼ ☼ ☼               ☼ ☼ ☼                                                       ☼ ☼ ☼               ☼ ☼ ☼   ☼
☼   ☼ ☼ ☼               ☼ ☼ ☼                                                       ☼ ☼ ☼               ☼ ☼ ☼   ☼
☼   ☼ ☼ ☼               ☼ ☼ ☼                                                       ☼ ☼ ☼               ☼ ☼ ☼   ☼
☼                                                                                                               ☼
☼                                                                                                               ☼
☼ ☼ ☼ ☼ ☼ ☼ ☼ 1 ☼ ☼ ☼ ☼ ☼ ☼ ☼ ☼ ☼ ☼ ☼ ☼ ☼ ☼ ☼ ☼ ☼ ☼ ☼ ☼ ☼ ☼ ☼ ☼ 1 ☼ ☼ ☼ ☼ ☼ ☼ ☼ ☼ ☼ ☼ ☼ ☼ ☼ ☼ ☼ ☼ ☼ ☼ ☼ ☼ ☼ ☼ ☼ ☼