☼ ☼ ☼ ☼ ☼ ☼ ☼ ʘ ☼ ☼ ☼ ☼ ☼ ☼ ☼ ☼ ☼ ☼ ☼ ☼ ☼ ☼ ☼ ☼ ☼ ☼ ☼ ☼ ʘ ☼ ☼ ☼ ☼ ☼ ☼ ☼ ☼ ☼ ☼ ☼ ☼ ☼ ☼ ☼ ☼ ☼ ☼ ʘ ☼ ☼ ☼ ☼ ☼ ☼ ☼ ☼ ☼
☼                                                                                                               ☼
☼                                                                                                               ☼
☼   ╬ ╬ ╬     ╬ ╬ ╬     ╬ ╬ ╬     ╬ ╬ ╬                                   ╬ ╬ ╬     ╬ ╬ ╬     ╬ ╬ ╬     ╬ ╬ ╬   ☼
☼   ╬ ╬ ╬     ╬ ╬ ╬     ╬ ╬ ╬     ╬ ╬ ╬                                   ╬ ╬ ╬     ╬ ╬ ╬     ╬ ╬ ╬     ╬ ╬ ╬   ☼
☼   ╬ ╬ ╬     ╬ ╬ ╬     ╬ ╬ ╬     ╬ ╬ ╬                                   ╬ ╬ ╬     ╬ ╬ ╬     ╬ ╬ ╬     ╬ ╬ ╬   ☼
☼                   ☼ ☼                                                                   ☼ ☼                   ☼
☼                   ☼ ☼                                                                   ☼ ☼                   ☼
☼                   ☼ ☼                                                                   ☼ ☼                   ☼
☼   ╬ ╬ ╬     ╬ ╬ ╬  2  ╬ ╬ ╬     ╬ ╬ ╬     ╬ ╬ ╬     ╬ ╬ ╬     ╬ ╬ ╬     ╬ ╬ ╬     ╬ ╬ ╬  2  ╬ ╬ ╬     ╬ ╬ ╬   ☼
☼   ╬ ╬ ╬     ╬ ╬ ╬     ╬ ╬ ╬     ╬ ╬ ╬     ╬ ╬ ╬     ╬ ╬ ╬     ╬ ╬ ╬     ╬ ╬ ╬     ╬ ╬ ╬     ╬ ╬ ╬     ╬ ╬ ╬   ☼
ʘ   ╬ ╬ ╬     ╬ ╬ ╬     ╬ ╬ ╬     ╬ ╬ ╬     ╬ ╬ ╬     ╬ ╬ ╬     ╬ ╬ ╬     ╬ ╬ ╬     ╬ ╬ ╬     ╬ ╬ ╬     ╬ ╬ ╬   ʘ
☼                             ☼ ☼                                               ☼ ☼                             ☼
☼                             ☼ ☼                                               ☼ ☼                             ☼
☼                             ☼ ☼                                               ☼ ☼                             ☼
☼   ╬ ╬ ╬     ╬ ╬ ╬     ╬ ╬ ╬  ʘ  ╬ ╬ ╬     ╬ ╬ ╬     ╬ ╬ ╬     ╬ ╬ ╬     ╬ ╬ ╬  ʘ  ╬ ╬ ╬     ╬ ╬ ╬     ╬ ╬ ╬   ☼
☼   ╬ ╬ ╬     ╬ ╬ ╬     ╬ ╬ ╬     ╬ ╬ ╬     ╬ ╬ ╬     ╬ ╬ ╬     ╬ ╬ ╬     ╬ ╬ ╬     ╬ ╬ ╬     ╬ ╬ ╬     ╬ ╬ ╬   ☼
☼   ╬ ╬ ╬     ╬ ╬ ╬     ╬ ╬ ╬     ╬ ╬ ╬     ╬ ╬ ╬     ╬ ╬ ╬     ╬ ╬ ╬     ╬ ╬ ╬     ╬ ╬ ╬     ╬ ╬ ╬     ╬ ╬ ╬   ☼
☼                                       ☼ ☼                           ☼ ☼                                       ☼
☼                                       ☼ ☼                           ☼ ☼                                       ☼
☼                                       ☼ ☼                           ☼ ☼                                       ☼
☼   ╬ ╬ ╬               ╬ ╬ ╬     ╬ ╬ ╬  1  ╬ ╬ ╬               ╬ ╬ ╬  1  ╬ ╬ ╬     ╬ ╬ ╬               ╬ ╬ ╬   ☼
☼   ╬ ╬ ╬               ╬ ╬ ╬     ╬ ╬ ╬     ╬ ╬ ╬               ╬ ╬ ╬     ╬ ╬ ╬     ╬ ╬ ╬               ╬ ╬ ╬   ☼
☼   ╬ ╬ ╬               ╬ ╬ ╬     ╬ ╬ ╬     ╬ ╬ ╬               ╬ ╬ ╬     ╬ ╬ ╬     ╬ ╬ ╬               ╬ ╬ ╬   ☼
☼                                                                                                               ☼
☼                                                                                                               ☼
☼                                                   ☼ ☼ ☼ ☼ ☼                                                   ☼
☼   ╬ ╬ ╬               ╬ ╬ ╬     ╬ ╬ ╬             ☼ ☼ ☼ ☼ ☼             ╬ ╬ ╬     ╬ ╬ ╬               ╬ ╬ ╬   ☼
ʘ   ╬ ╬ ╬               ╬ ╬ ╬     ╬ ╬ ╬             ☼ ☼ ☼ ☼ ☼             ╬ ╬ ╬     ╬ ╬ ╬               ╬ ╬ ╬   ʘ
☼   ╬ ╬ ╬               ╬ ╬ ╬     ╬ ╬ ╬             ☼ ☼ ☼ ☼ ☼             ╬ ╬ ╬     ╬ ╬ ╬               ╬ ╬ ╬   ☼
☼                                                   ☼ ☼ ☼ ☼ ☼                                                   ☼
☼                                                                                                               ☼
☼                                                                                                               ☼
☼   ╬ ╬ ╬               ╬ ╬ ╬     ╬ ╬ ╬     ╬ ╬ ╬               ╬ ╬ ╬     ╬ ╬ ╬     ╬ ╬ ╬               ╬ ╬ ╬   ☼
☼   ╬ ╬ ╬               ╬ ╬ ╬     ╬ ╬ ╬     ╬ ╬ ╬               ╬ ╬ ╬     ╬ ╬ ╬     ╬ ╬ ╬               ╬ ╬ ╬   ☼
☼   ╬ ╬ ╬               ╬ ╬ ╬     ╬ ╬ ╬  1  ╬ ╬ ╬               ╬ ╬ ╬  1  ╬ ╬ ╬     ╬ ╬ ╬               ╬ ╬ ╬   ☼
☼                                       ☼ ☼                           ☼ ☼                                       ☼
☼                                       ☼ ☼                           ☼ ☼                                       ☼
☼                                       ☼ ☼                           ☼ ☼                                       ☼
☼   ╬ ╬ ╬     ╬ ╬ ╬     ╬ ╬ ╬     ╬ ╬ ╬     ╬ ╬ ╬     ╬ ╬ ╬     ╬ ╬ ╬     ╬ ╬ ╬     ╬ ╬ ╬     ╬ ╬ ╬     ╬ ╬ ╬   ☼
☼   ╬ ╬ ╬     ╬ ╬ ╬     ╬ ╬ ╬     ╬ ╬ ╬     ╬ ╬ ╬     ╬ ╬ ╬     ╬ ╬ ╬     ╬ ╬ ╬     ╬ ╬ ╬     ╬ ╬ ╬     ╬ ╬ ╬   ☼
☼   ╬ ╬ ╬     ╬ ╬ ╬     ╬ ╬ ╬  ʘ  ╬ ╬ ╬     ╬ ╬ ╬     ╬ ╬ ╬     ╬ ╬ ╬     ╬ ╬ ╬  ʘ  ╬ ╬ ╬     ╬ ╬ ╬     ╬ ╬ ╬   ☼
☼                             ☼ ☼                                               ☼ ☼                             ☼
☼                             ☼ ☼                                               ☼ ☼                             ☼
☼                             ☼ ☼                                               ☼ ☼                             ☼
ʘ   ╬ ╬ ╬     ╬ ╬ ╬     ╬ ╬ ╬     ╬ ╬ ╬     ╬ ╬ ╬     ╬ ╬ ╬     ╬ ╬ ╬     ╬ ╬ ╬     ╬ ╬ ╬     ╬ ╬ ╬     ╬ ╬ ╬   ʘ
☼   ╬ ╬ ╬     ╬ ╬ ╬     ╬ ╬ ╬     ╬ ╬ ╬     ╬ ╬ ╬     ╬ ╬ ╬     ╬ ╬ ╬     ╬ ╬ ╬     ╬ ╬ ╬     ╬ ╬ ╬     ╬ ╬ ╬   ☼
☼   ╬ ╬ ╬     ╬ ╬ ╬  2  ╬ ╬ ╬     ╬ ╬ ╬     ╬ ╬ ╬     ╬ ╬ ╬     ╬ ╬ ╬     ╬ ╬ ╬     ╬ ╬ ╬  2  ╬ ╬ ╬     ╬ ╬ ╬   ☼
☼                   ☼ ☼                                                                   ☼ ☼                   ☼
☼                   ☼ ☼                                                                   ☼ ☼                   ☼
☼                   ☼ ☼                                                                   ☼ ☼                   ☼
☼   ╬ ╬ ╬     ╬ ╬ ╬     ╬ ╬ ╬     ╬ ╬ ╬                                   ╬ ╬ ╬     ╬ ╬ ╬     ╬ ╬ ╬     ╬ ╬ ╬   ☼
☼   ╬ ╬ ╬     ╬ ╬ ╬     ╬ ╬ ╬     ╬ ╬ ╬                                   ╬ ╬ ╬     ╬ ╬ ╬     ╬ ╬ ╬     ╬ ╬ ╬   ☼
☼   ╬ ╬ ╬     ╬ ╬ ╬     ╬ ╬ ╬     ╬ ╬ ╬                                   ╬ ╬ ╬     ╬ ╬ ╬     ╬ ╬ ╬     ╬ ╬ ╬   ☼
☼                                                                                                               ☼
☼                                                                                                               ☼
☼ ☼ ☼ ☼ ☼ ☼ ☼ ʘ ☼ ☼ ☼ ☼ ☼ ☼ ☼ ☼ ☼ ☼ ☼ ☼ ☼ ☼ ☼ ☼ ☼ ☼ ☼ ☼ ʘ ☼ ☼ ☼ ☼ ☼ ☼ ☼ ☼ ☼ ☼ ☼ ☼ ☼ ☼ ☼ ☼ ☼ ☼ ʘ ☼ ☼ ☼ ☼ ☼ ☼ ☼ ☼ ☼